Open,High,Low,Close,Volume,Accumulation Distribution Line,MACD,Chaikan Oscillator (CHO),Highest closing price (5 days),Lowest closing price (days),Stochastic %K (5 days),%D,Volume Price Trend (VPT),Williams %R (14 days),Relative Strength Index,Momentum (10 days),Price rate of change (PROC),Volume rate of change (VROC),On Balance Volume (OBV)
23.780001,25.25,23,24.49,3504900,3760944.74,-1.040772795,1104270.237,25.25,23.07,67.93250298,32.60767054,-103087.5331,-26.38889805,45.57545716,-0.26,0,113.0508784,6976600
24.129999,24.18,22.790001,23.209999,2635600,3306135.521,-1.039891324,1394334.679,25.25,23.07,17.07309637,31.75863938,-286275.5897,-80.31496838,38.39248997,-1.710001,-5.956243922,107.2827369,4341000
23.26,23.639999,22.809999,23.219999,836100,-812573.8922,-1.026552379,75741.25798,25.25,23.07,17.4796006,34.16173332,-285140.0446,-82.5203994,38.47407405,-0.790001,-6.181822222,-22.57616446,5177100
23.25,23.75,22.940001,23.25,634500,-275258.5317,-1.002009793,-299604.9141,25.25,23.07,18.69915394,17.75061697,-284059.776,-81.30084606,38.73619161,-0.85,-6.701444623,-29.16154963,5811600
23.639999,24.139999,23.049999,23.08,1283100,-1404262.646,-0.984923611,-785147.3922,25.25,23.08,11.78858203,15.98911219,-288699.1308,-88.21141797,37.75465534,-0.83,-3.873386089,22.3864937,4528500
23.01,23.17,22.559999,22.84,953700,-1458188.127,-0.979458098,-929559.478,24.18,22.84,17.28400168,15.92391255,-302041.5918,-89.59104476,36.35413241,-1.100001,-5.228215768,14.86209804,3574800
23.1,24.969999,23.07,24.73,4115100,6062367.521,-0.813244856,1488772.327,24.969999,22.84,90.04153527,39.70470632,-223123.3344,-19.33084783,51.58527353,1.100001,3.429527394,481.3930489,7689900
24.629999,25.49,23.549999,23.6,2618400,3891274.256,-0.763895508,1651944.543,25.49,22.84,35.49490256,47.60681317,-411156.6138,-64.50509744,44.69794073,0.140001,-1.420221327,359.7717296,5071500
23.33,23.49,22.959999,23.18,2370700,-3285068.393,-0.7500304,-714861.7157,25.49,22.84,21.16043646,48.8989581,-457755.2579,-78.83956354,42.43038567,0.11,-1.904354715,363.0273438,2700800
22.879999,23,21.780001,21.870001,2064600,-2591556.18,-0.835121414,-1397450.234,25.49,21.870001,2.425876665,19.69373856,-591733.4559,-97.57412334,36.25280655,-2.619999,-6.77748537,279.5220588,636200
22.18,22.5,21.110001,21.83,1605600,-1344371.782,-0.895462072,-1152818.662,25.49,21.83,16.43833709,13.34155007,-595509.6818,-83.56166291,36.08006642,-1.379999,-5.374945817,79.37660597,-969400
21.780001,22.58,21.5,22.530001,1055300,1420212.086,-0.876692285,-68300.09149,25.49,21.83,32.42009873,17.09477083,-544024.496,-67.57990127,41.34696087,-0.689998,-8.003262556,-69.89072441,85900
22.809999,23.85,22.690001,23.610001,1346300,1998156.644,-0.76584197,565467.1458,23.85,21.83,91.24090921,46.69978167,-493437.5475,-42.9223614,48.41002853,0.360001,1.72340378,-48.9186523,1432200
23.74,24.1,23.5,23.889999,1051200,1002097.29,-0.647929867,456401.4806,24.1,21.83,92.97655283,72.21252026,-477471.3768,-36.52971154,50.08814617,0.809999,2.885443707,25.72658773,2483400
24.049999,24.32,23.700001,23.940001,1106400,-370534.2415,-0.544176009,-66453.73151,24.32,21.83,88.16202123,90.79316109,-475271.2049,-35.3881131,50.39843747,1.100001,2.967746237,74.37352246,3589800
23.82,24.280001,23.73,24.02,663300,-533783.0741,-0.450304251,-326250.6076,24.32,22.530001,89.36170213,90.16675873,-471574.0082,-33.5616515,50.92411081,-0.71,4.072790295,-48.3048866,4253100
24.48,24.790001,24.059999,24.360001,640200,-306245.4319,-0.344503743,-330473.661,24.790001,23.610001,79.52380952,85.68251096,-462185.0547,-25.79906982,53.19448747,0.760001,6.654995622,-32.87197232,4893300
24.48,24.99,23.780001,24.950001,1580100,1611441.756,-0.210620112,308014.9825,24.99,23.889999,97.31550336,88.73367167,-446679.3903,-12.32874711,56.9190203,1.770001,0.889611808,-61.60239119,6473400
24.93,25.4,24.700001,24.940001,2033600,948182.8337,-0.10412302,330176.5902,25.4,23.940001,72.94121938,83.26017742,-447312.6969,-12.55705766,56.83646698,3.07,5.677970339,-22.33424992,4439800
24.6,24.959999,24,24.66,1399900,-361834.4657,-0.041834803,-107597.0373,25.4,24.02,55.68862275,75.31511516,-470143.8922,-18.94977602,54.45492332,2.83,6.384814495,-40.9499304,3039900
24.66,24.99,24.27,24.719999,924800,555824.0433,0.012229502,15077.5531,25.4,24.360001,58.02460372,62.21814862,-466737.8662,-17.57993552,54.89110038,2.189998,13.03154033,-55.20681972,3964700
24.440001,24.49,23.73,24.01,1017000,-288197.9987,-0.002189889,-204660.5417,25.4,24.01,16.76646707,43.49323118,-493299.6422,-32.40093995,48.92058976,0.399999,9.986257444,-36.65919283,2947700
23.85,24.25,23.530001,24.07,930800,-87625.04347,-0.008675852,-212129.2273,25.4,24.01,28.87696731,34.5560127,-490758.2011,-31.00233823,49.42126452,0.180001,6.835325928,-11.7975931,3878500
23.82,24,23.200001,23.25,1166000,-764896.7864,-0.079071682,-411395.6781,24.99,23.25,2.793241784,16.14555872,-522468.0474,-50.1165618,43.19044977,-0.690001,-1.524781808,-13.39226027,2712500
22.200001,22.959999,21.799999,22.950001,1318800,470428.4135,-0.157255552,-62456.14633,24.99,22.950001,36.05020813,22.57347241,-537513.1585,-62.82048718,41.14657037,-1.069999,-3.934692505,25.456621,1393700
22.860001,23.25,22.690001,22.82,1169700,759151.6723,-0.227089086,177836.1669,24.49,22.82,37.91823869,25.58722954,-544983.5425,-71.66664676,40.25752048,-1.540001,-4.678366555,5.721258134,224000
23.24,23.43,22.639999,22.809999,922600,-1313328.348,-0.280011859,-399454.8174,24.25,22.809999,41.22447297,38.39763993,-545496.1704,-71.94445224,40.18558482,-2.140002,-5.037472939,39.0924167,-698600
23.190001,23.190001,22.51,22.959999,687900,-490343.5019,-0.306318739,-337446.4221,24,22.809999,52.72724876,43.95665347,-539429.0943,-67.77778673,41.86353219,-1.980002,-5.747134411,7.450796626,-10700
23.049999,23.049999,22.540001,22.73,411700,-103218.6139,-0.34178623,-158226.3031,23.43,22.73,57.05524107,50.33565427,-546320.049,-74.16664606,40.01016207,-1.93,-8.897799243,-73.94468705,-422400
22.73,22.860001,22,22.190001,582900,-523466.8426,-0.408755994,-204240.1179,23.43,22.190001,13.28678322,41.02309102,-556100.8492,-89.16661412,35.98236415,-2.529998,-11.02646307,-71.33654603,-1005300
22.110001,22.27,21.77,22.209999,422800,-208072.9249,-0.454971712,-104144.0575,23.43,22.190001,26.50596386,32.28266271,-555575.5299,-87.87881543,36.2383613,-1.800001,-9.935121655,-69.7978427,-582500
22.139999,22.379999,21.98,22.33,462200,239290.7427,-0.476423015,88614.95751,23.190001,22.190001,39.43659195,26.40977967,-553291.1344,-84.57300275,37.84455406,-1.74,-9.668281135,-50.0216263,-120300
22.43,23,22.4,22.75,568000,66129.3444,-0.454295997,104318.2044,23.049999,22.190001,76.56255981,47.50170521,-544597.7175,-69.56521739,43.23435674,-0.5,-5.247813411,-44.14945919,447700
22.700001,23.540001,22.549999,23.25,1058100,392855.464,-0.391896811,205217.0976,23.540001,22.190001,83.61577197,66.53830791,-532114.201,-54.03726708,48.91376365,0.299999,-3.40673037,13.67640739,1505800
23.299999,24,23.209999,23.92,755400,890560.7803,-0.285095206,386198.6003,24,22.209999,96.41255605,85.53029595,-501622.7171,-20.95588235,55.35902556,1.1,2.88172043,-35.21440823,2261200
24.110001,24.49,23.01,23.709999,1223300,671434.4377,-0.214922004,355405.506,24.49,22.33,68.92426295,82.98419699,-508254.6049,-28.67650735,53.09779727,0.9,3.311537982,-7.241431604,1037900
26.549999,28.709999,26.5,27.75,11517800,9605641.496,0.164785537,3153200.985,28.709999,22.75,84.78606732,83.37429544,-299813.7178,-13.83284061,74.5960192,4.790001,21.60385627,884.6798324,12555700
27.450001,28.18,26.57,26.66,2864800,6947221.807,0.373447735,3165238.236,28.709999,23.25,66.72079545,73.47704191,-752224.6007,-29.53889475,65.8289232,3.93,16.87856716,210.5137654,9690900
26.83,27,25.23,25.83,2609300,-2606035.426,0.466462873,-157259.1202,28.709999,23.709999,49.47369289,66.99351855,-841413.798,-41.49855065,60.04219665,3.639999,12.5000049,279.3138538,7081600
25.9,27,25.690001,26.700001,3180900,2325048.965,0.603423954,66815.09647,28.709999,23.709999,64.73687101,60.31045312,-753527.8666,-28.96251138,63.6492754,4.490002,17.46590849,672.6256983,10262500
26.99,27.01,25.799999,26.49,1288300,2819539.65,0.687100802,309745.6669,28.709999,25.83,36.20690696,50.13915695,-778546.2994,-31.98846282,62.18992249,4.16,19.37809286,121.0156116,8974200
26.85,27.940001,26.450001,27.24,2810300,1235136.295,0.804658437,-123160.6823,28.18,25.83,68.13559322,56.35979039,-742071.2144,-21.18154484,65.25397742,4.49,22.64746162,564.6877956,11784500
27.58,27.6,26.360001,26.49,1946400,-589456.1512,0.827763041,-869614.4505,27.940001,25.83,46.49444779,50.27898265,-819447.3158,-31.98846282,60.01625416,3.24,18.62964622,321.1163998,9838100
26.469999,26.530001,25.02,25.27,1369400,-2289641.583,0.739109804,-1636894.134,27.940001,25.27,8.561640904,41.06389397,-909088.9919,-49.56771608,52.61764304,1.35,11.07692308,141.0915493,8468700
25.08,25.209999,24.299999,24.65,1357400,-1160558.524,0.611770546,-1442719.019,27.940001,24.65,9.615406805,21.55716517,-942687.2507,-60.32688861,49.29200957,0.940001,6.021505376,28.28655137,7111300
25.129999,25.690001,24.809999,24.93,1211500,-1261143.47,0.52736776,-1264131.771,27.940001,24.65,17.30771027,11.82825266,-927268.5083,-59.90490648,50.80425256,-2.82,4.222408027,60.37860736,8322800
24.870001,25.280001,24.200001,25.139999,983400,-103998.8075,0.471982389,-707969.8889,27.6,24.65,27.64700813,18.19004174,-917063.3824,-57.95454545,51.96137581,-1.520001,6.031210714,-19.61088858,9306200
25.65,26.18,25.41,25.58,943500,222114.6291,0.45831037,-312324.8537,26.530001,24.65,59.22742489,34.7273811,-899851.8867,-54.91227279,54.3824343,-0.25,-7.81981982,-91.80833145,10249700
25.129999,25.620001,24.360001,25.030001,1033900,-366214.583,0.3985012,-309272.5565,26.18,24.65,41.91921309,42.93121537,-920138.2064,-64.56137975,50.92734947,-1.67,-6.114024756,-63.91022061,9215800
25.26,25.26,24.65,25.16,548700,398471.4026,0.35747113,-36599.02528,26.18,24.93,48.48482247,49.87715348,-914768.4117,-78.71398169,51.70832095,-1.33,-2.593883082,-78.97137163,9764500
25.700001,26.09,25.299999,25.75,837200,206313.5496,0.368316846,17135.28657,26.18,25.030001,78.28281731,56.22895096,-901901.4403,-61.05529172,55.19356154,-1.49,-3.558056047,-73.68040492,10601700
25.85,26.98,25.59,26.74,1386100,1371115.751,0.451591218,408178.6339,26.98,25.030001,90.83969116,72.53577698,-869713.9452,-32.08558824,60.36284976,0.25,0.943752359,7.591399519,11987800
26.700001,26.73,25.969999,26.389999,800900,1332768.431,0.483768025,518842.3437,26.98,25.030001,77.48086927,82.20112591,-887856.6672,-41.44390374,57.82299054,1.119999,-3.120414831,-71.50126321,11186900
26.66,27.25,26.309999,26.93,1400000,369486.2115,0.546541751,210447.4878,27.25,25.16,87.69230769,85.33762271,-871468.3831,-27.00537433,60.57898106,2.28,1.661004153,-28.07233868,12586900
26.93,27.360001,26.629999,27.08,996900,457639.2385,0.601460861,93203.05639,27.360001,25.75,86.40773164,83.86030287,-863670.3883,-22.99467914,61.33477576,2.15,7.162643451,-27.20169417,13583800
27.07,27.690001,26.719999,27.66,1600000,1520748.593,0.683902206,375028.4875,27.690001,26.389999,98.57138163,90.89047366,-842318.7635,-0.859627507,64.19342093,2.520001,12.21095335,17.87240312,15183800
27.690001,27.870001,27.42,27.6,726000,1149594.871,0.73591292,338132.8445,27.870001,26.389999,85.78943601,90.2561831,-845789.4793,-7.356975477,63.66900518,2.02,10.70998797,-40.07428807,14457800
27.6,27.799999,27.059999,27.450001,784600,-370017.5502,0.756309852,-191213.2203,27.870001,26.93,73.07695759,85.81259175,-849735.1052,-11.44414169,62.29879669,2.42,9.188552474,-20.2155786,13673200
27.379999,27.389999,26.5,26.870001,913900,-260915.5821,0.717403631,-355666.6006,27.870001,26.870001,27.00735255,61.95791538,-866313.1738,-27.2479564,57.17503042,1.710001,5.043006255,-3.137254902,12759300
26.780001,27,25.75,26.690001,1044500,526977.2028,0.664387036,-139916.4972,27.870001,26.690001,44.3396489,48.14131968,-872435.3172,-32.15258856,55.64546306,0.940001,6.632041285,1.025244221,11714800
27.200001,27.440001,26.17,26.440001,1218500,92344.03517,0.595335435,-177227.7813,27.870001,26.440001,32.54720163,34.63140102,-882218.9437,-40.74074074,53.50452121,-0.299999,5.087444356,122.0703481,10496300
26.9,27.700001,26.620001,27.120001,981700,-666811.1042,0.588695742,-417929.2344,27.799999,26.440001,66.82934967,47.90540007,-850880.8208,-21.36752137,58.21386993,0.730002,5.320392233,17.259914,11478000
27,28,26.85,27.91,916400,863306.4799,0.639804784,8451.15097,28,26.440001,96,65.1255171,-822284.1398,-2.686567164,62.91354431,0.98,4.375467464,-33.88644398,12394400
28.24,28.950001,27.91,28.33,1535300,629216.143,0.706060531,107627.915,28.950001,26.440001,80.6249748,81.15144149,-808493.8137,-16.98631946,65.15719945,1.25,7.351273488,91.69684105,13929700
28.200001,28.299999,26.92,27.07,962500,-983954.9551,0.649411211,-374865.8414,28.950001,26.440001,32.37408907,69.66635463,-876777.5412,-55.95239406,54.50410198,-0.59,0.51986632,-31.25,12967200
27.07,27.74,26.65,27.67,628000,-113275.6342,0.64549039,-261136.6086,28.950001,27.07,45.06433476,52.68779955,-855443.9616,-40.00001875,58.023625,0.07,2.17872969,-37.00471462,13595200
28,28.190001,27.299999,27.549999,661500,289918.914,0.625489777,-62582.14725,28.950001,27.07,39.13037429,38.85626604,-858167.5116,-43.75004883,57.07267412,0.099998,-0.397689805,-58.65625,12933700
27.99,27.99,26.549999,26.6,755700,-1001984.965,0.526908296,-386726.3612,28.950001,26.6,2.083373264,28.75936077,-880977.8332,-73.4375083,50.07579953,-0.270001,-3.623188406,4.090909091,12178000
27,27,25.719999,25.959999,1234200,-1398253.835,0.392613229,-610259.42,28.299999,25.959999,9.302325581,16.83869105,-899160.1173,-92.56966404,45.98563962,-0.730002,-5.42805809,57.30308437,10943800
26.1,26.469999,25.52,26.35,729500,-193241.3783,0.314033263,-262813.5787,28.190001,25.959999,31.08613068,14.15727651,-880618.5436,-75.80175633,48.73362704,-0.090001,-1.935247416,-20.17726228,11673300
27.030001,28.440001,26.6,28.200001,2655100,4415183.754,0.396467463,1369532.588,28.440001,25.959999,91.78082473,44.056427,-829401.2484,-21.86588284,59.30898256,1.08,5.657549432,154.1981809,14328400
28.26,28.280001,27.35,27.969999,842500,4143359.766,0.438186776,1826318.151,28.440001,25.959999,83.90404661,68.92366734,-851056.5068,-28.57147855,57.71495767,0.059999,5.786679055,-30.85761182,13485900
27.620001,27.620001,26.620001,26.82,863600,-276647.4129,0.374141455,440790.1295,28.440001,25.959999,44.5205327,73.40180135,-885696.2706,-62.09913641,50.41845581,-1.51,-1.106198337,-12.03015178,12622300
27.02,27.5,26.6,26.719999,613700,-976392.3561,0.311722488,-388734.7368,28.440001,26.35,41.09584209,56.50680713,-888916.2879,-65.01461661,49.82853193,-0.350001,-4.263708348,-33.03142732,12008600
26.9,29.01,26.17,28.98,4693100,12679805.37,0.439551327,3652407.525,29.01,26.719999,98.94366197,61.52001225,-837009.0025,-0.859598854,60.9490896,1.31,2.294387575,205.6796717,16701700
28.82,29.76,28.1,29.48,3336900,17180107.4,0.574579034,6405479.321,29.76,26.719999,92.2005571,77.41335372,-756037.6429,-6.603773585,62.90792072,1.930001,8.902844477,246.6909091,20038600
29.540001,29.67,28.82,29.549999,1687100,5035471.902,0.679406029,3085217.459,29.76,26.719999,94.15038997,95.09820302,-748114.3165,-4.952853774,63.18632857,2.949999,6.794358511,168.6464968,21725700
29.690001,30.280001,29.549999,30.139999,3290500,2303733.424,0.80085845,577264.6854,30.280001,26.719999,96.59362613,94.31485774,-714429.4084,-2.941217869,65.5344997,4.18,9.40108927,397.4300831,25016200
30,30.1,28.379999,28.52,1529900,119148.0105,0.757656199,-1196289.961,30.280001,28.52,57.17760166,82.64053926,-891290.9507,-36.97480316,55.13534323,2.17,7.218045113,102.4480614,23486300
28.52,29.32,28.51,28.76,986300,-1626496.329,0.734319322,-2368513.701,30.280001,28.52,30.27521547,61.34881442,-878416.6169,-31.93278741,56.24312845,0.559999,10.78582861,-20.08588559,24472600
29.950001,31.5,29.5,30.129999,6209200,-776826.7336,0.816954802,-2362390.932,31.5,28.52,56.08972561,47.84751425,-831433.654,-22.90971572,62.00969939,2.16,14.34534725,751.1583276,30681800
30.1,30.129999,28.26,28.700001,2331100,-1098433.325,0.758313758,-2247452.721,31.5,28.52,13.58027778,33.31507295,-1126128.107,-46.82272575,54.00884882,1.880001,1.773049583,-12.20293021,28350700
28.940001,29.389999,28.26,28.370001,1222100,-1725619.116,0.677403383,-2195677.775,31.5,28.370001,3.395092593,24.35503199,-1152931.695,-52.3411204,52.33082805,1.650002,1.430110884,45.05637982,27128600
28.440001,28.6,27.02,27.120001,1695900,-2387672.892,0.506577266,-2185543.52,31.5,27.120001,2.232165179,6.40251185,-1206778.186,-82.17634146,46.44446393,-1.859999,1.118571961,96.37563687,25432700
27.43,28.1,27.1,27.620001,1603200,-1354840.581,0.40685222,-1654083.451,31.5,27.120001,13.39287946,6.340045745,-1175511.594,-72.79547842,48.91954239,-1.859999,3.368271084,161.2351312,27035900
27.52,28.299999,27.35,27.860001,1566600,137518.1494,0.343228868,-811455.3308,30.129999,27.120001,27.00968714,14.21157726,-1161580.82,-68.29266417,50.1113664,-1.689998,-3.864730849,-66.61907907,28602500
28.07,28.879999,27.879999,28.43,1713400,244730.3698,0.334940079,-358862.1815,29.389999,27.120001,59.49369599,33.2987542,-1129529.119,-57.59849906,52.92089272,-1.709999,-3.561736771,-48.65294135,30315900
28.540001,29.700001,28.52,28.6,1573400,-1169513.477,0.338190285,-591073.2826,29.700001,27.120001,58.95520188,48.486195,-1119283.674,-54.40900563,53.757331,0.08,-3.214886742,-6.739375259,31889300
28.440001,28.450001,27.07,27.32,1345000,-2105947.66,0.234774461,-930291.1292,29.700001,27.32,9.505699808,42.65153256,-1189701.576,-93.30357143,46.98810052,-1.44,-9.356334086,-59.12475308,30544300
27.67,28,25.74,26.5,1842200,-587717.8713,0.085662069,-501417.031,29.700001,26.5,19.19191435,29.21760535,-1230071.268,-86.80555556,43.23233189,-3.629999,-7.082748948,20.4130989,28702100
26.870001,27.700001,26.139999,26.5,1714000,-524046.3479,-0.032140085,-260126.0487,29.700001,26.5,19.19191435,15.96317617,-1230071.268,-86.80555556,43.23233189,-2.200001,-7.8581363,73.78079692,28702100
26.290001,26.459999,25.5,26.01,1537800,-637984.1318,-0.16315727,-174021.21,29.700001,26.01,12.14285425,16.84222765,-1261764.098,-91.5,40.96321647,-2.360001,-13.67407613,-75.23352445,27164300
26.24,27.73,26,27.530001,1496000,2179369.485,-0.142693079,773454.3029,28.450001,26.01,68.81356989,33.3827795,-1171896.45,-66.16665,49.77045306,0.41,-4.07665491,-35.82428896,28660300
27.370001,28.25,27.1,27.209999,1475600,943791.973,-0.150560974,697605.5951,28.25,26.01,62.18178182,47.71273532,-1189285.588,-71.50001667,48.14214739,-0.410002,-4.08883313,20.74298339,27184700
27.200001,27.719999,26.209999,27.709999,1170000,575109.2447,-0.115123444,485849.747,28.25,26.01,80.3636,70.4529839,-1162170.556,-52.26782986,50.84802004,-0.150002,2.175508769,-31.01008314,28354700
27.639999,27.969999,27.26,27.57,3608500,832931.1282,-0.097215062,437088.4314,28.25,26.01,75.27272727,72.60603636,-1168081.737,-50.71429745,50.06038215,-0.86,-0.181031854,125.0810878,24746200
27.73,28.280001,27.309999,27.459999,1809400,-2172506.981,-0.090851422,-578870.4534,28.280001,27.209999,64.03501577,73.22378102,-1182479.22,-53.33336825,49.41272121,-1.140001,-1.435757307,15.49853185,22936800
27.790001,28.25,27.67,28.110001,889200,-1081570.514,-0.032978309,-594749.2619,28.280001,27.209999,91.78744755,77.0317302,-1139649.153,-37.85713384,53.26074766,0.790001,-1.125568062,-48.10318665,23826000
28.5,29.09,28.07,28.290001,1461800,-648294.9694,0.027098669,-409316.623,29.09,27.459999,72.22226659,76.01490997,-1133955.236,-33.57142058,54.29750971,1.790001,-1.083912587,-7.092919792,25287800
28.5,29.33,28.4,29.129999,946700,-337413.2715,0.140867097,-197330.3101,29.33,27.459999,90.33811594,84.78261003,-1090550.887,-13.57147296,58.88132275,2.629999,6.625179356,-29.6133829,26234500
29.07,29.6,28.799999,29.02,854900,55774.76715,0.219621733,32435.76742,29.6,27.459999,74.67250014,79.07762756,-1094125.76,-16.19049615,58.06010185,3.01,9.509433962,-53.59352948,25379600
29.02,29.52,28.709999,29.139999,996000,-470702.7824,0.288393842,-44033.30911,29.6,28.110001,76.1657513,80.39212246,-1090590.71,-11.21953659,58.73622371,1.609998,9.962260377,-41.89031505,26375600
29.139999,29.139999,28.549999,28.959999,926900,58266.03713,0.324629609,96995.17571,29.6,28.290001,58.16986928,69.66937357,-1096743.079,-15.60978049,57.24542854,1.75,11.34178777,-39.725582,25448700
29.139999,30,29.01,29.73,1327900,691179.4037,0.410744554,347252.4293,30,28.959999,83.125,72.48687353,-1072098.26,-6,61.72125386,2.020001,7.991278315,-11.23663102,26776600
29.889999,29.889999,28.59,28.809999,1240600,-163788.8866,0.400142285,146026.6289,30,28.809999,17.93102212,53.07529713,-1113190.4,-26.44446667,54.39426729,1.239999,5.880191322,-15.92572513,25536000
28.4,28.530001,28,28.35,975800,-747597.3305,0.350580562,-135325.397,30,28.35,17.5,39.51867404,-1132998.619,-41.25,51.12622509,0.890001,2.309639203,-16.5982906,24560200
28.370001,29.09,28,28.17,1045400,-694512.9527,0.293395957,-221231.1604,30,28.17,8.5,14.64367404,-1139194.174,-48.28494768,49.86375867,0.059999,2.176278564,-71.02951365,23514800
28.43,29.030001,27.9,28.639999,1066000,-283712.0949,0.282742458,-105553.1397,30,28.17,35.23804762,20.41268254,-1121752.323,-35.88392193,53.11899227,0.349998,4.297159661,-41.08544269,24580800
28.530001,28.959999,27.25,27.610001,1159000,-76832.1521,0.18900848,17190.86329,29.889999,27.610001,13.63640668,19.1248181,-1160089.54,-86.90905455,46.06090555,-1.519998,-1.778726369,30.34188034,23421800
27.790001,27.83,27.4,27.58,709000,-782347.3229,0.111022994,-158640.5865,29.09,27.58,17.93478261,22.26974564,-1161348.908,-88,45.86972341,-1.44,-2.509724195,-51.49815296,22712800
27.34,27.450001,26.629999,27.23,851900,-2007.468452,0.020737807,32140.19104,29.09,27.23,24.39027464,18.65382131,-1170346.37,-82.19582131,43.59629429,-1.909999,-6.522482201,-10.01373191,21860900
27.58,28.110001,27.540001,27.889999,1026100,245672.5848,0.002414713,186072.3269,29.030001,27.23,52.49995625,31.60833783,-1149698.073,-62.61128706,48.75420099,-1.07,-3.893869745,20.025734,22887000
28,30.440001,27.799999,28.690001,3048300,655431.9693,0.051849319,362506.8842,30.440001,27.23,54.06826558,43.65283216,-1120265.226,-45.93173442,54.21910571,-1.039999,-1.544262236,206.0542169,25935300
28.91,29.16,28.1,28.700001,1011500,860290.3539,0.09078698,466911.6996,30.440001,27.23,54.33073263,53.63298482,-1119202.731,-45.66926737,54.2847322,-0.109998,-0.89778318,9.127198188,26946800
28.700001,29.540001,28.549999,29.290001,583500,452392.1154,0.167324613,337390.4391,30.440001,27.23,69.81628881,59.40509568,-1098408.829,-30.18371119,58.10097135,0.940001,-1.479983182,-56.05843814,27530300
29.01,29.25,28.440001,28.49,673300,-313631.745,0.161565418,9997.746185,30.440001,27.889999,32.75858621,52.30186922,-1114346.028,-51.18110174,51.78809281,0.32,-1.11072201,-45.72787361,26857000
28.309999,28.77,27.969999,28,760600,-1307332.549,0.116123707,-441022.0428,30.440001,28,7.575789715,36.71688824,-1125926.127,-64.04198738,48.32468743,-0.639999,-1.234567901,-22.05369953,26096400
28.5,28.5,27.51,27.639999,958500,-1417291.115,0.050479852,-620424.0416,29.540001,27.639999,6.403888471,15.57942146,-1135705.297,-73.49082756,45.89616501,0.029998,-1.8814377,-8.312607614,25137900
27.6,28.549999,27.540001,28.17,938700,-469827.2564,0.040753494,-335947.8097,29.540001,27.639999,32.51229926,15.49732581,-1117325.92,-59.58004746,49.88885044,0.59,-1.641058018,-11.94183865,26076600
27.799999,28.4,27.5,28.17,948200,631182.2561,0.032668701,161290.7491,29.25,27.639999,38.28571429,25.73396734,-1117325.92,-59.58004746,49.88885044,0.94,2.028246938,-18.18809318,26076600
28.67,28.98,28.209999,28.77,1164900,727621.7997,0.073825417,380729.0371,28.98,27.639999,85.81081081,52.20294145,-1097129.967,-43.83202424,54.31526498,0.880001,4.314720812,64.30183357,27241500
28.690001,29.200001,27.27,27.34,1549400,-1050100.597,-0.008844683,-129751.4291,29.200001,27.34,3.626941126,42.57448874,-1155030.801,-81.36481293,44.27687337,-1.350001,0.403966214,81.87580702,25692100
27.5,27.83,26.34,27.200001,1794500,-600221.4975,-0.084681921,-183645.4129,29.200001,27.200001,30.06995452,39.83590215,-1162964.76,-79.02437097,43.43059816,-1.5,-2.473997937,74.88548874,23897600
26.51,26.889999,24.67,24.75,3064500,-1924382.841,-0.3385752,-610321.9781,29.200001,24.75,1.766004025,11.82096656,-1324601.769,-98.61351844,31.92923725,-4.540001,-13.73301102,0.531443756,20833100
24.99,25.379999,22.83,24.24,1964400,-817305.4448,-0.574319789,-377135.767,29.200001,24.24,22.13500437,17.99032097,-1387749.041,-81.47175014,30.13993258,-4.25,-15.54007263,94.20662383,18868700
23.1,24.440001,23.1,23.639999,2608500,1742873.301,-0.800338339,567145.9899,29.200001,23.639999,12.71583788,12.20561543,-1436372.885,-89.35612492,28.1418438,-4.360001,-19.28986619,347.0437018,16260200
24.15,25.450001,23.700001,25.059999,1333400,1367533.323,-0.855021381,782457.9893,27.83,23.639999,44.59998,26.48360742,-1279686.33,-66.76604072,38.52832839,-2.58,-12.03931555,98.03950691,17593600
25.440001,25.440001,23.629999,23.82,1564200,413460.132,-0.987037686,495838.8839,26.889999,23.639999,24.38424246,27.23335345,-1345664.572,-85.24590384,33.91792,-4.35,-14.92857143,105.6534315,16029400
24.040001,25.75,24,25.299999,836500,-230453.2775,-0.961158373,128627.812,25.75,23.639999,84.58900685,51.19107644,-1248476.728,-61.52649533,42.7270594,-2.870001,-8.465991623,-12.72822118,16865900
25.6,27.139999,25.360001,26.309999,1009100,1360455.745,-0.849359386,472909.9887,27.139999,23.639999,79.45544046,62.80956326,-1215082.853,-45.36894107,47.83744069,-2.460001,-6.602772453,7.499733674,17875000
26.620001,26.75,25.93,26.23,738600,241306.572,-0.758469964,214667.9614,27.139999,23.82,74.07410256,79.37284996,-1218151.154,-46.62481215,47.47609186,-1.11,-6.886758963,-22.10504113,17136400
26.129999,26.540001,25.83,26.1,537700,-434844.311,-0.688987141,-125630.6908,27.139999,23.82,70.37039886,74.63331396,-1221811.772,-48.66562815,46.85668818,-1.100001,-9.280500521,-53.84153146,16598700
26.389999,26.65,25.51,25.83,643700,-445072.1039,-0.648235788,-256677.1017,27.139999,25.299999,58.28027334,67.57492492,-1227374.185,-52.90424601,45.52812064,1.08,-5.52304316,-58.45488576,15955000
25,25.15,23.469999,24.26,1056600,17940.68051,-0.734162953,-139630.4655,27.139999,24.26,21.52591281,50.05886167,-1266499.582,-77.55102393,38.6632685,0.02,-10.80882681,-41.12008916,14898400
23.860001,24.219999,22,22.299999,1375300,-501891.5985,-0.949471632,-244455.2517,26.75,22.299999,6.315768421,28.70731819,-1351863.847,-95.8333478,32.1465725,-1.34,-9.898993939,-55.12155327,13523100
23.110001,23.799999,21.68,21.950001,986100,-1371123.842,-1.135260647,-541688.8096,26.65,21.950001,5.432615694,11.09143231,-1373449.15,-95.60973984,31.13731044,-3.109998,-9.447190594,-49.8014661,12537000
21.93,23.110001,21.5,22.959999,869000,593512.0869,-1.187314757,11071.51302,26.65,21.950001,28.34949515,13.36595975,-1328075.165,-74.11348832,37.25885925,-0.860001,-2.876480663,-66.68583477,13406000
23.1,23.93,22.83,23.870001,684300,1862123.221,-1.141974487,639843.2319,25.15,21.950001,64.93153425,32.90454836,-1293633.014,-57.97869822,42.24086826,-1.429998,-4.748595561,-48.680066,14090300
23.870001,23.870001,22.9,23.110001,679800,284480.2766,-1.15406431,336923.159,24.219999,21.950001,59.191235,50.82408813,-1315420.529,-71.45387792,39.4251973,-3.199998,-2.980684299,-56.54008439,13410500
22.709999,23.950001,22.07,23.73,761800,785573.2585,-1.100926053,341810.609,23.950001,21.950001,91.02037101,71.71438009,-1297182.74,-60.4609859,42.77629521,-2.5,-6.20552989,-8.93006575,14172300
24.219999,24.85,24.02,24.709999,803400,1594271.809,-0.968570792,570049.5039,24.85,22.959999,95.82086567,82.01082389,-1265722.005,-43.08511402,47.70128624,-1.390001,-6.081338125,-20.38450104,14975700
24.5,24.77,24.09,24.629999,366200,541183.9533,-0.860217572,276523.8699,24.85,23.110001,92.08629496,92.97584388,-1268323.058,-44.50355399,47.34307847,-1.200001,-6.09988944,-50.41971297,14609500
24.799999,25.5,24.280001,24.74,823800,-11887.15207,-0.756747391,-44670.50198,25.5,23.110001,77.8425656,88.58324208,-1266687.558,-42.5531813,47.92217252,0.48,-5.210727969,53.20810861,15433300
24.66,24.870001,23.84,24,848100,-714900.5683,-0.726088447,-395693.3318,25.5,23.73,56.26822157,75.39902738,-1291328.301,-52.38095238,44.38580413,1.700001,-7.084785134,31.75392263,14585200
23.66,23.99,22.68,23.07,769900,-821092.5684,-0.767981428,-537109.823,25.5,23.07,13.82978723,49.3135248,-1324192.176,-69.51456311,40.35531584,1.119999,-4.905193735,-27.13420405,13815300
22.5,23.200001,22.290001,22.940001,809800,54566.44166,-0.802421931,-267515.0823,25.5,22.940001,20.24922749,30.11574543,-1328530.548,-72.03881553,39.81111444,-0.019998,2.869964254,-41.11830146,13005500
23.389999,24,23.280001,23.84,459200,450105.5261,-0.748466028,-7053.426756,25.5,22.940001,48.28658825,27.45520099,-1296759.878,-41.5,45.3097566,-0.030001,8.610473412,-53.43271473,13464700
23.58,24.030001,23.280001,23.610001,505700,38795.95463,-0.716010857,-30730.93797,24.870001,22.940001,51.1627907,39.89953548,-1301190.06,-47.249975,44.19849766,0.5,2.831019287,-41.80667434,12959000
23.370001,23.57,22.549999,22.969999,669300,-228911.1525,-0.733477639,-122803.005,24.030001,22.940001,39.08034483,46.17657459,-1314898.192,-63.250025,41.17248536,-0.760001,-3.770431346,-2.192021043,12289700
22.5,23.309999,22.450001,22.879999,566600,-152263.9446,-0.745983207,-124917.1931,24.030001,22.879999,33.90793103,41.38368885,-1317520.613,-65.500025,40.74997594,-1.83,-0.995248767,-16.65195646,11723100
23.01,24.1,22.75,24.08,726500,915818.245,-0.651553208,225418.3533,24.1,22.879999,98.78787805,57.25871797,-1287803.804,-41.39941691,48.35928684,-0.549999,1.474926254,-4.633762142,12449600
24.25,24.84,23.790001,24.34,830800,1016801.782,-0.549403742,380375.9882,24.84,22.879999,79.07948915,70.59176608,-1279959.535,-33.81924198,49.86174516,-0.4,-1.4973655,3.410505352,13280400
24.58,24.93,24.33,24.82,562600,233850.4115,-0.4248205,160067.2221,24.93,22.879999,95.56451434,91.14396052,-1263575.64,-19.82507289,52.60338321,0.82,0.771421063,53.63189514,13843000
24.780001,25.84,24.49,25.799999,1417100,1986941.052,-0.244194729,613190.9104,25.84,22.879999,98.82002915,91.15467755,-1241361.803,-1.12678905,57.69025081,2.729999,4.284555376,72.01990774,15260100
24.950001,25.809999,23.82,25.77,1157400,4048076.633,-0.102289048,1398630.931,25.84,24.08,97.73462783,97.37305711,-1243009.539,-1.971831541,57.48685712,2.829999,7.375,36.46975593,14102700
25.98,26.6,25.67,26.01,1180400,1886146.334,0.029201603,904912.1228,26.6,24.34,79.00355125,91.85273608,-1232230.493,-13.6890983,58.74014798,2.17,12.74382315,53.31861281,15283100
25.950001,26.950001,25.700001,25.85,987600,-1068469.692,0.119125029,-319433.5907,26.950001,24.82,64.85620931,80.5314628,-1239491.7,-23.60517167,57.52266998,2.239999,12.685261,21.95603853,14295500
25.639999,26.110001,24.879999,25.629999,775800,-441851.7664,0.170670368,-591884.4436,26.950001,25.629999,57.82742561,67.22906206,-1247896.845,-28.32622318,55.80979423,2.66,7.508385067,68.94599303,13519700
25.49,26.620001,25.35,26.379999,1156400,1251654.922,0.268938991,-110690.8967,26.950001,25.629999,81.7890793,68.15757141,-1225194.932,-12.23180258,60.16467692,3.5,11.73230785,128.6731264,14676100
26.52,26.52,24.9,25.52,934800,975095.8741,0.274261337,8227.75685,26.950001,25.52,30.91789283,56.84479925,-1262894.056,-31.7778,53.63729974,1.44,11.10144149,39.66831017,13741300
26,26.99,25.57,26.190001,674500,40730.11246,0.328753154,-241169.8778,26.99,25.52,62.08537342,58.26411518,-1238351.856,-17.62112723,57.50536189,1.850001,14.46679259,19.04341687,14415800
26,26.5,24.51,24.59,723300,-598167.4636,0.240064291,-524557.241,26.99,24.59,3.225806452,32.07635757,-1279558.448,-52.86344777,47.34655716,-0.23,2.117940199,-0.440467997,13692500
25.719999,25.82,23.549999,24.120001,929600,-802660.2491,0.130350142,-657867.2994,26.99,24.120001,16.56982076,27.29366688,-1293383.185,-63.21585093,44.84063603,-1.679998,-0.903857847,11.89215214,12762900
24.799999,24.889999,23.49,24.389999,1336100,559008.1156,0.064444593,-219338.9982,26.99,24.120001,25.71425714,15.16996145,-1282977.292,-61.3207783,46.58949183,-1.380001,-1.73247784,137.486669,14099000
24.950001,25,23.25,23.73,1023200,473894.8945,-0.040574713,-47082.62732,26.99,23.73,12.8342246,18.3727675,-1319132.466,-87.1657754,43.00047558,-2.28,-8.023252249,-27.79620351,13075800
23.290001,24.32,22.93,23.66,1200300,54877.52415,-0.127976451,-105657.5819,26.5,23.66,20.44817927,19.66555367,-1322150.755,-82.01970443,42.62542006,-2.19,-8.187815289,3.706583722,11875500
24.030001,25.84,23.35,25.370001,1229500,2557809.807,-0.05858484,676372.7161,25.84,23.66,83.84883162,39.04374516,-1235400.366,-39.9014532,53.33347878,-0.259998,-2.460588235,4.159606913,13105000
25.370001,27.6,25.02,26.959999,1769100,5244722.46,0.123286888,1789732.526,27.6,23.66,86.2954818,63.5308309,-1158344.692,-13.7045182,60.68153795,0.58,4.294,79.13122722,14874100
26.98,27.6,26.049999,26.99,1311600,3709932.614,0.266767246,1594152.722,27.6,23.66,86.9379015,85.69407164,-1156376.043,-13.0620985,60.80693873,1.47,5.30628581,69.0641918,16185700
27.309999,28.18,27,27.879999,923500,1294617.738,0.447137621,600710.549,28.18,23.66,94.28569524,89.17302618,-1113125.851,-5.714304762,64.43113868,1.689998,5.686126068,-20.14008993,17109200
27.51,27.77,27.09,27.610001,575700,741796.7571,0.561819554,-36205.24754,28.18,25.370001,88.19877847,89.8074584,-1122069.293,-10.85712381,62.54171877,3.020001,8.189659091,-38.41463415,16533500
27.25,28,27.200001,27.799999,1123400,557092.5967,0.660424105,-352239.8292,28.18,26.959999,87.9746519,90.15304187,-1118107.618,-7.238114286,63.35606291,3.679998,6.147376627,66.55300222,17656900
27.629999,28.469999,27.440001,27.940001,1043500,377990.3795,0.741320433,-506491.97,28.469999,26.99,78.0992562,84.75756219,-1112450.127,-9.566752629,63.97750943,3.550002,13.62342822,44.26932117,18700400
28,28.549999,27.26,28.049999,1400500,548368.103,0.80502742,-469339.3001,28.549999,27.610001,67.74191467,77.93860759,-1108341.934,-8.896798736,64.48710187,4.319999,16.29352337,50.65619621,20100900
27.860001,28,27.26,27.42,754500,92918.85647,0.795509869,-556388.9408,28.549999,27.42,22.60275521,56.14797536,-1139796.965,-20.10674735,59.31186121,3.76,12.42312884,-43.52967592,19346400
27.299999,28.43,26.709999,28.34,999700,1106557.282,0.852377773,-218898.0276,28.549999,27.42,88.58701087,59.64389358,-1114481.867,-3.736637676,63.87159166,2.969999,19.4268858,-2.296716185,20346100
28.02,28.059999,27.299999,27.57,792900,1280075.14,0.82579419,-5723.514609,28.549999,27.42,46.73918478,52.64298362,-1141643.793,-17.43770773,58.01188465,0.610001,16.52578191,-33.94151462,19553200
27.440001,27.469999,27,27.34,999700,-233740.2332,0.777208258,-399663.9677,28.549999,27.34,34.23918478,56.52179348,-1148258.483,-21.53023515,56.34894776,0.35,7.765072615,-18.6905246,18553500
27.4,28.299999,27.01,28.030001,1142600,989692.6642,0.785328098,-135214.2342,28.43,27.34,76.74425771,52.57420909,-1123028.271,-9.252635098,60.04888428,0.150002,3.968850296,-35.41348708,19696100
27.870001,28.889999,27.75,28.549999,940600,1398254.88,0.824221509,115259.0196,28.889999,27.34,84.40366972,65.1290374,-1101831.35,-6.137185223,62.62029839,0.939998,5.779914783,-28.28606282,20636700
28.23,28.860001,27.799999,28.25,654400,389841.0571,0.821369174,-113611.6857,28.889999,27.34,66.13760113,75.76184285,-1111715.03,-16.53744613,60.21243354,0.450001,1.327119847,-29.13914456,19982300
28.190001,28.370001,27.4,27.98,510500,8729.176333,0.788235644,-318175.1467,28.889999,27.34,51.85187929,67.46438338,-1117969.473,-32.04221831,58.04901537,0.039999,1.340090498,-11.32534306,19471800
28.34,28.950001,28.110001,28.76,869400,459295.2036,0.815515805,-229573.2678,28.950001,27.98,90.20613907,69.39853983,-1103738.236,-8.482179927,62.26687907,0.710001,3.453241131,-22.60993413,20341200
28.5,30,28.01,29.870001,1264000,2636927.13,0.916142612,520426.1382,30,27.98,95.00003846,79.01935227,-1070183.477,-3.951336185,67.30476468,2.450001,6.907659023,21.13080977,21605200
29.5,29.51,28.75,29.370001,1134000,2762656.924,0.944654867,819937.5443,30,27.98,75.76926923,86.99181559,-1091341.829,-19.14889995,63.21076381,1.030001,4.705889651,-19.02891824,20471200
28.389999,28.92,28,28.879999,635200,1025545.172,0.917139752,315207.7854,30,27.98,56.92303846,75.89744872,-1110261.211,-34.04257324,59.39761579,1.309999,5.324576951,-15.81179589,19836000
29,29.26,28.25,28.709999,875300,457345.0263,0.871569337,-100718.7793,30,28.709999,35.49995,56.0640859,-1114000.27,-39.20974492,58.08838067,1.369999,1.30557163,-12.44373312,18960700
30,32.490002,29.530001,32.459999,2509700,7253965.04,1.125078905,1900846.61,32.490002,28.709999,99.33178203,63.91825683,-999671.6347,-0.519082776,72.4920663,4.429998,17.73666667,216.5216295,21470400
31.459999,32.400002,30.51,32.310001,3032900,12642775.07,1.298910449,4261485.951,32.490002,28.709999,95.99107083,76.94093429,-1011268.985,-3.114202536,71.43455163,3.760002,18.17849671,203.3810143,18437500
31.639999,32,30.75,31.27,1266300,5233754.571,1.337337812,2482378.618,32.490002,28.709999,72.82847535,89.38377607,-1108892.598,-22.22225056,64.41781926,3.02,11.5590399,10.82618589,17171200
31.370001,32,30.719999,31.84,1167900,1081018.582,1.397674489,207566.1108,32.490002,28.709999,84.66977138,84.49643919,-1085810.059,-11.83974068,66.36770378,3.86,11.52364664,24.16542632,18339100
30.870001,31.49,30.299999,30.879999,953700,1226335.963,1.352437624,-695671.3037,32.490002,30.879999,45.60802513,67.70209062,-1121023.161,-29.37960607,60.36756242,2.119999,9.309730973,45.73655257,17385400
30.940001,31.5,30.65,31.33,747300,422978.1808,1.337480757,-1257548.513,32.400002,30.879999,49.0475966,59.77513104,-1107125.299,-22.78981423,62.09738035,1.459999,11.97283774,46.38589618,18132700
31.9,34.5,30.57,33.639999,3868300,11387881.93,1.494793892,2115748.232,34.5,30.879999,79.52379059,58.05980411,-1052025.961,-12.11269014,69.46504555,4.269998,16.96800765,344.9390384,22001000
33,33.540001,32.619999,33.220001,1325700,11363488.54,1.567506122,3295630.982,34.5,30.879999,69.52384059,66.03174259,-1100321.987,-18.02815493,66.91807339,4.340002,11.21526578,4.881329114,20675300
32.919998,34.400002,32.73,33.93,891000,1152749.365,1.663249172,229835.9172,34.5,30.879999,86.42857466,78.49206861,-1071988.283,-8.769230769,68.98812466,5.220001,15.52604305,-21.42857143,21566300
33.48,35,33.400002,34.939999,1833200,3572815.023,1.799876848,-275226.256,35,31.33,98.64557562,84.86599696,-1045465.763,-0.857157143,71.70088285,2.48,20.98338023,188.6020151,23399500
34.5,34.900002,33.189999,33.68,1349300,2452876.249,1.785897165,-813166.1862,35,33.220001,70.20316027,85.09243685,-1111574.241,-18.85714286,64.16063459,1.369999,17.31104554,54.15286188,22050200
33.639999,34.110001,32.540001,32.599998,902800,-1115634.542,1.668438312,-2094743.574,35,32.599998,2.43890343,57.09587977,-1154841.661,-34.28574286,58.48344817,1.329998,0.431296994,-64.02757302,21147400
32.439999,32.439999,31.049999,31.76,1031600,-586364.3748,1.490390216,-2260189.855,35,31.76,17.97470431,30.20558934,-1178103.939,-48,54.44806022,-0.08,-1.702262405,-65.9863497,20115800
31.76,32.790001,31.049999,32.07,732600,671877.9803,1.358638685,-1722050.779,35,31.76,25.82280359,15.41213711,-1168034.795,-53.56490924,55.66390432,1.190001,2.558362648,-42.1464108,20848400
31.76,32.049999,31.25,31.450001,451800,195618.9902,1.19047288,-1496889.856,34.900002,31.450001,10.38965424,18.06238738,-1182197.915,-75.53187755,52.63780772,0.120001,-1.224871231,-61.31518109,20396600
31.549999,32.41,31.08,31.66,239600,-244633.6242,1.061904458,-1408778.05,34.110001,31.450001,19.93466017,18.715706,-1179181.141,-71.06381467,53.55873239,-1.979999,2.525910056,-74.87679564,20636200
32,33.279999,31.809999,32.560001,681200,181108.5277,1.020867689,-1109198.168,33.279999,31.450001,67.71309417,32.6791362,-1172370.016,-51.91486129,57.38330192,-0.66,3.925952761,-8.845175967,21317400
32.490002,33.07,31.629999,31.75,591100,-293655.3897,0.91246709,-1036867.811,33.279999,31.450001,31.39017937,39.67931124,-1189316.35,-69.14892146,53.14159799,-2.18,-5.618308728,-84.71938578,20726300
32.5,32.93,32.220001,32.740002,760300,-279010.6472,0.89611388,-908357.7185,33.279999,31.450001,75.45467066,58.1859814,-1170885.164,-51.01575621,57.29643638,-2.199997,-1.444909649,-42.64916648,21486600
32.57,33.990002,31.98,32.599998,1030200,118191.7847,0.861921001,-646824.8415,33.990002,31.66,52.23357235,53.02614079,-1174136.386,-54.17611738,56.53302619,-1.080002,-3.919840849,15.62289562,20456400
32.830002,33.689999,32.400002,33.299999,802800,406103.7831,0.881149782,-389423.4977,33.990002,31.75,70.76262191,66.15028831,-1152015.495,-43.0379891,59.4426873,0.700001,-4.693760867,-56.2077242,21259200
33.529999,35,33.43,34.419998,1160100,1199733.278,0.975518123,3797.663786,35,31.75,82.78926327,68.59515251,-1125014.437,-14.68359122,63.63687499,2.659998,2.197143705,-14.02208553,22419300
34.200001,34.98,34.029999,34.869999,951800,1409225.921,1.074233933,230972.374,35,32.599998,95.69533113,83.08240544,-1109847.493,-3.291163724,65.1943084,2.799999,6.963193679,5.427558706,23371100
34.630001,34.889999,33.799999,34.189999,674300,519242.9958,1.085088384,19733.60904,35,32.599998,73.17877483,83.88778974,-1128408.549,-20.50634924,60.94638795,2.739998,7.651130353,-34.63551764,22696800
30.84,31.65,29.610001,30.889999,3305800,2829782.918,0.81797904,666695.5796,35,30.889999,23.74764819,64.20725138,-1193491.616,-76.25235181,45.46436962,-0.770001,-3.679454319,351.2421512,19391000
30.540001,31.120001,30.280001,31.040001,1239500,3823814.996,0.61134961,1187036.085,35,30.889999,26.53061717,41.15234673,-1177438.634,-73.46938283,46.13419341,-1.52,-1.303656556,174.3470562,20630500
30.440001,30.620001,30.02,30.41,758700,854319.559,0.392237019,347150.827,34.98,30.41,14.8975633,21.72527622,-1202596.051,-85.15771524,43.70617539,-1.34,-3.948199621,216.6527546,19871800
30.57,30.93,28.91,29.450001,994100,-161187.8307,0.139516556,-351113.7505,34.889999,29.450001,9.030118567,16.81943301,-1226547.094,-91.13298851,40.23153546,-3.290001,-9.551596758,45.93364651,18877700
29.5,29.68,28,28.530001,1163900,-371383.414,-0.133464053,-671728.4223,31.65,28.530001,14.52057534,12.81608574,-1257602.17,-92.42855714,37.18091093,-4.069997,-10.14172913,96.90407714,17713800
28.67,29.17,28.120001,28.620001,700300,-196521.8971,-0.338637304,-686184.9943,31.120001,28.530001,19.87182055,14.47417149,-1253930.561,-91.14284286,37.67875989,-4.679998,-12.5839974,-7.891621728,18414100
28.790001,28.93,27.98,28,1029700,-1004101.597,-0.544985233,-886675.7697,30.93,28,0.677966102,11.69012067,-1269101.305,-99.71509972,35.58645369,-6.419998,-14.11042418,-0.048534265,17384400
28.09,28.5,27.370001,27.75,987000,-1267458.168,-0.7203862,-971883.1076,30.93,27.75,10.67413221,10.40797296,-1278295.055,-95.01967169,34.74854335,-7.119999,-16.66666416,22.94469357,16397400
28.049999,28.450001,27.719999,27.9,843300,-763597.6472,-0.837633268,-758068.3886,29.68,27.75,22.94368959,11.4319293,-1272959.92,-93.05374745,35.72641376,-6.289999,-18.9424706,-27.30799069,17240700
27.91,28.07,26.030001,27.57,1705500,1724885.799,-0.946272615,190106.7646,29.17,27.57,49.04456976,27.55413052,-1282934.436,-82.83167033,34.50141577,-3.319999,-20.93489879,79.18680395,15535200
27.6,28.049999,27.299999,27.77,1009400,2306031.072,-1.004650764,745624.0266,28.93,27.57,59.99998621,43.99608185,-1270562.292,-80.60201567,35.93514306,-3.270001,-18.77741792,49.69598102,16544600
28,28,27.52,27.9,591400,199101.3553,-1.028569247,234710.3577,28.5,27.57,75.70849219,61.58434939,-1265836.977,-79.10615409,36.90196941,-2.51,-9.679505007,-82.1102305,17136000
27.66,28.77,27.639999,28.57,777500,686988.9465,-0.982139919,159599.8761,28.77,27.57,92.70072726,76.13640189,-1251634.898,-71.33183326,41.77867812,-0.880001,-7.957477192,-37.27309399,17913500
28.99,29.24,28.040001,28.51,575200,505895.0797,-0.939357512,56743.00541,29.24,27.57,77.25855989,81.88925978,-1253267.73,-55.87189606,41.46957618,-0.020001,-6.247944755,-24.18610782,17338300
28.59,29.34,28.549999,28.73,488200,-368657.7917,-0.877583746,-268760.0831,29.34,27.77,70.09805387,80.01911368,-1248829.147,-46.95483301,43.13099374,0.109999,-2.444825044,-50.89025249,17826500
28.49,28.98,28.25,28.559999,339800,-379251.7667,-0.832745875,-380858.5129,29.34,27.9,57.1428022,68.16647199,-1251717.921,-48.36737722,42.13567863,0.559999,0.105145457,-70.80505198,17486700
28.940001,29.5,27.65,28.08,928100,-403460.6346,-0.826417026,-399796.2818,29.5,28.08,23.65595502,50.29893703,-1257428.834,-58.16327718,39.37292382,0.33,-1.886795881,32.52891618,16558600
28.209999,28.67,27.5,27.709999,630100,-697981.7563,-0.841556418,-464909.7004,29.5,27.709999,10.49995,30.43290241,-1269658.105,-53.97264492,37.34047581,-0.190001,-1.035717857,-38.80741964,15928500
27.76,27.93,26.85,27.120001,1005500,-867323.3603,-0.890892745,-503163.9093,29.5,27.120001,10.18871698,14.78154067,-1283074.119,-68.5878872,34.2999571,-0.449999,-2.270266667,1.874366768,14923000
27.200001,27.790001,26.41,26.91,986300,-618433.25,-0.936146156,-393878.8769,29.5,26.91,16.18122977,12.28996558,-1290860.107,-74.63979096,33.26178607,-0.86,-3.548387097,16.95719198,13936700
27,27.49,26.120001,27.25,897000,720675.1157,-0.933810268,112715.7414,29.5,26.91,33.43193297,19.93395991,-1278398.494,-64.84151725,36.6072559,-0.65,-1.160681901,-47.40545295,14833700
27.440001,27.76,27.25,27.620001,671800,920622.6049,-0.891822694,373331.7645,28.67,26.91,58.82355248,36.14557174,-1266219.012,-54.17866115,40.12478951,-0.949999,-0.540147641,-33.44561125,15505500
27.620001,28.379999,27.299999,28.23,672300,596017.5976,-0.800102337,342724.7476,28.379999,26.91,93.36287023,61.87278523,-1251382.035,-36.59943418,45.49448953,-0.28,1.182795699,13.6794048,16177800
28.48,28.620001,27.809999,28.25,729300,519620.9093,-0.717528241,274738.8627,28.620001,26.91,85.19996,79.12879424,-1250905.733,-36.98225946,45.66654001,-0.48,-1.120056003,-6.199356913,16907100
28.4,28.5,22.639999,22.790001,5500400,-4546776.31,-1.080211952,-1390085.284,28.620001,22.790001,2.50839381,60.35707468,-1391860.68,-97.81338224,23.68557747,-5.769998,-20.06313223,856.2586926,11406700
26.620001,27.34,26.41,26.6,4651600,-7352001.042,-1.048124205,-2837349.824,28.620001,22.790001,66.22073036,51.30969472,-472311.8617,-42.27404632,43.95709355,-1.48,-7.413853115,852.806227,16058300
26.690001,26.879999,26.25,26.809999,1260200,-2251780.823,-0.99428774,-1548674.354,28.620001,22.790001,69.73241815,46.15384744,-435588.8787,-39.21283685,44.82702111,-0.9,-6.127451195,270.8652148,17318500
27.190001,27.74,26.610001,26.76,1246300,-328230.8544,-0.944765783,-268661.7311,28.620001,22.790001,68.89631475,68.28315442,-437939.0742,-39.94168514,44.64931351,-0.360001,-4.700854701,34.28509859,16072200
26.9,27,26.4,26.6,662300,-1202992.483,-0.9079635,1070.344828,28.5,22.790001,67.57679734,68.73517675,-445390.7932,-42.27404632,44.04754265,-0.31,-4.005770625,5.110299952,15409900
26.809999,27.209999,26.6,26.77,594600,-636882.865,-0.855221387,291443.7685,27.74,26.6,34.89932886,57.12414698,-441158.0488,-39.79591257,44.8973153,-0.48,-1.290564112,-40.86524117,16004500
26.629999,27.68,26.440001,27.42,858000,333126.2395,-0.752301254,692377.2688,27.74,26.6,78.52348993,60.33320538,-426720.6189,-20.72968147,48.14042511,-0.200001,1.895206243,-13.00821251,16862500
27.27,28.01,27.049999,27.969999,611200,1197772.494,-0.619218024,1068566.848,28.01,26.6,97.51546584,70.31276154,-409510.5845,-10.86959503,50.78017158,-0.260001,2.642198165,-31.86176143,17473700
28.07,29.58,28,28.940001,1271100,1216796.849,-0.430514844,1131373.349,29.58,26.6,79.87424528,85.30440035,-388314.1153,-9.221886279,55.1191706,0.690001,4.779145374,89.20809765,18744800
28.5,29.719999,28.5,29.33,748400,1061889.921,-0.246653289,1004926.226,29.719999,26.77,88.10977934,88.49983015,-371184.616,-5.508460452,56.76929733,6.539999,3.896563939,11.31935148,19493200
29.49,29.610001,28.530001,29.57,729000,1113088.39,-0.08064605,878131.3502,29.719999,27.42,95.42685697,87.8036272,-365060.6473,-2.118629944,57.79761165,2.97,4.672566372,-0.041135335,20222200
29.9,30,28.870001,29.07,956400,135311.2793,0.010449605,435319.6975,30,27.969999,68.47458696,84.00374109,-377387.3298,-12.63586785,54.86936938,2.260001,27.55593999,-82.61217366,19265800
29.07,29.700001,29,29.58,523200,-382083.3646,0.122385522,49969.38945,30,28.940001,79,80.96714798,-360608.3824,-5.706520964,57.24857805,2.82,11.20300752,-88.75225729,19789000
29.719999,30.879999,29.610001,30.25,805700,329733.1987,0.262137189,114270.4982,30.879999,29.07,73.52944266,73.66800987,-348757.6725,-7.645618932,60.21587017,3.65,12.83103741,-36.06570386,20594700
30.41,31.33,30.25,31.15,764500,676602.5799,0.440436788,240554.8004,31.33,29.07,93.57142628,82.03362298,-324786.4328,-3.543307087,63.84597209,4.38,16.40508221,-38.65842895,21359200
31.1,31.9,31.049999,31.799999,652100,972990.0094,0.626962757,364653.0335,31.9,29.07,96.69963587,87.9335016,-308833.8089,-1.769929204,66.24173551,4.379999,19.54886842,-1.540087574,22011300
31.799999,31.799999,30.82,31.6,1021600,1000715.71,0.750002125,391092.0304,31.9,29.58,89.65517241,93.30874485,-312935.0463,-5.454545455,64.81847029,3.630001,18.04258498,71.81298352,20989700
31.6,32.009998,31.290001,31.93,623700,918227.8538,0.864178244,340108.0268,32.009998,30.25,96.66674583,94.34051804,-302266.4387,-1.425989813,66.11227104,2.989999,16.44784829,-27.30769231,21613400
32,32.900002,31.43,32.580002,1277100,1520528.589,0.995636294,479973.1659,32.900002,31.15,87.92453742,91.41548522,-289569.7194,-4.953559605,68.56448676,3.250002,16.48195626,108.9496073,22890500
32.259998,32.27,29.84,31.1,1874200,2649759.177,0.969221373,852857.4401,32.900002,31.1,41.17644368,75.25590897,-347584.1589,-27.86380374,58.23189193,1.53,7.463714324,47.44709307,21016300
31.549999,32.060001,30.9,31.49,1157900,1573291.796,0.968591775,585356.164,32.900002,31.1,53.92153338,61.00750483,-324081.3293,-24.10258593,59.94488324,2.42,7.364473236,54.71672902,22174200
31.74,33.790001,31.4,33.169998,1810800,2849555.41,1.091077352,828793.5043,33.790001,31.1,84.30372549,59.80056752,-262307.1253,-10.70816741,66.3474879,3.589998,12.17449442,148.3950617,23985000
33.099998,34.41,32.27,33.599998,2761800,5363194.711,1.2089099,1652830.966,34.41,31.1,82.2756674,73.50030876,-238832.7796,-13.7056176,67.76764096,3.349998,15.58306846,188.770389,26746800
33.5,34.509998,32.540001,34.18,2219700,5896311.238,1.333720063,2009307.826,34.509998,31.1,92.93365864,86.50435051,-191158.6838,-5.518363972,69.62937286,3.03,15.55104801,324.2545872,28966500
33.990002,34.970001,33.5,34.970001,1376700,5292229.925,1.479326736,1780267.23,34.970001,31.49,100,91.73644201,-139854.8447,0,72.00152359,3.170002,15.60330909,70.87005089,30343200
34.869999,34.869999,33.810001,34.5,1135800,2410993.074,1.539054657,607969.1491,34.970001,33.169998,86.83470957,93.25612274,-158357.8576,-7.872712249,68.57006391,2.9,10.75441413,48.5676913,29207400
34.5,34.720001,32.5,34.220001,1654600,2860498.862,1.54597485,216147.3077,34.970001,33.599998,72.22223251,86.35231403,-167575.9116,-13.99253731,66.53567417,2.290001,7.610069422,153.7340899,27552800
33.990002,34.970001,33.560001,34.529999,820400,3013030.013,1.558507892,84739.43807,34.970001,34.18,82.18616106,80.41436771,-152586.938,-8.577035365,67.67900374,1.949997,9.272148734,-19.69459671,28373200
34.23,34.52,33.27,33.75,959900,409227.448,1.48834431,-805204.5463,34.970001,33.75,50.60726696,68.33855351,-171118.9739,-23.78169127,61.94430537,2.65,5.699968681,53.90412057,27413300
33.41,34,33,33.619999,606000,14892.388,1.406041204,-1221542.373,34.970001,33.619999,45.34407071,59.37916624,-174816.3949,-26.31582333,61.01632245,2.129999,3.192133015,-52.54874325,26807300
33.639999,34.439999,33.169998,33.810001,612200,233560.064,1.340692307,-1211237.008,34.970001,33.619999,53.03645626,49.66259798,-171391.6116,-22.61208136,61.91436307,0.640003,8.713829582,-67.33539644,27419500
33.810001,34.119999,33.139999,33.41,535700,-155347.8253,1.242305572,-1220652.14,34.970001,33.41,20.81217218,39.73089972,-178634.457,-30.40937029,58.84122233,-0.189998,6.097173706,-53.73521029,26883800
33.509998,34.5,33.310001,34.41,703500,477174.2681,1.230836699,-912278.3795,34.52,33.41,92.76315789,55.53726211,-162600.3355,-10.9161967,63.6930406,0.23,3.738324012,-61.14976806,27587300
34.400002,34.5,33.709999,34.040001,550000,581892.4065,1.178308896,-669871.6716,34.5,33.41,69.3334,60.96957669,-170164.8312,-22.85011724,60.83555051,-0.93,1.309532816,-80.08545152,27037300
34.349998,34.400002,33.459999,33.77,467000,-306969.8524,1.102188072,-792627.676,34.5,33.41,46.32356888,69.47337559,-174527.3619,-33.61346397,58.76373238,-0.73,-1.19953189,-78.96112087,26570300
33.25,33.279999,32.619999,33.110001,573800,-34850.97273,0.977339208,-684205.7001,34.5,33.110001,26.06392231,47.24029706,-183654.3839,-68.88886337,53.92893153,-1.11,-5.318844572,-58.32062178,25996500
33.119999,33.310001,32.91,33.119999,364900,36667.66061,0.86918294,-554894.8084,34.5,33.110001,26.59573053,32.99440724,-183481.1175,-74.89883607,53.99068615,-1.41,-4.000002899,-67.87286494,26361400
33.110001,33.490002,33.040001,33.07,633300,-668783.3905,0.77055138,-676011.6137,34.5,33.07,23.93621067,25.5319545,-184031.9821,-76.92308627,53.6037235,-0.68,-3.360610656,-61.72488819,25728100
33.200001,35.310001,33.200001,34.740002,1553400,1400516.293,0.817714261,-5690.260879,35.310001,33.07,78.81046185,43.11413435,-152050.964,-20.2846547,63.11328594,1.120003,0.608175517,89.34666017,27281500
34.689999,36.290001,34.599998,36.009998,1963300,4415569.046,0.946656778,1228384.374,36.290001,33.07,92.37049462,65.03905571,-95263.06327,-7.387940003,68.41512578,2.199997,6.69629037,104.5317221,29244800
36.509998,36.59,35.5,36.09,1001600,2574464.078,1.043273932,1035755.655,36.59,33.07,86.41304348,85.86466665,-90901.27667,-12.59445527,68.72012923,2.68,7.346820564,65.28052805,30246400
36,36,34.799999,35.290001,851500,44928.12447,1.043264387,57941.04402,36.59,33.07,63.38029954,80.72127921,-113103.521,-32.7455585,62.24695898,0.880001,4.377403006,39.08853316,29394900
35.279999,35.48,34.779999,35,571600,-352767.4884,1.008233872,-473880.9051,36.59,34.740002,53.0973313,67.63022477,-120100.853,-40.05036775,60.03914589,0.959999,4.759054175,6.70151204,28823300
34.900002,35.889999,34.830002,35.32,729300,-301016.7894,0.994825534,-631898.216,36.59,35,36.18096866,50.88619983,-114874.7958,-31.98991638,61.6553068,1.55,2.644580064,3.667377399,29552600
35.259998,35.32,34.540001,34.98,1015600,-30650.65428,0.945860875,-553070.7805,36.59,34.98,21.46337632,36.91389209,-121895.2375,-40.55414596,58.92829311,1.869999,2.76145409,84.65454545,28537000
34.98,35.200001,34.57,34.959999,567000,9292.9568,0.895123687,-457834.7006,36,34.959999,28.767006,28.80378366,-122475.9412,-41.05794936,58.76363505,1.84,3.523834765,21.41327623,27970000
34.939999,35.299999,34.599998,35.150002,607200,208978.9071,0.860328425,-313716.711,35.889999,34.959999,45.1853262,31.80523618,-119394.3707,-36.27198079,59.90965544,2.080002,6.161283414,5.820843499,28577200
34.970001,35.150002,34.299999,34.400002,522400,-204847.0512,0.763433806,-357911.5464,35.889999,34.400002,6.289496855,26.74727635,-132350.2733,-55.16366369,53.57973803,-0.34,3.864743474,43.16251028,28054800
34.259998,34.630001,33.150002,34.080002,1170600,244940.2443,0.653292054,-200339.699,35.32,34.080002,42.85718236,31.4440018,-137209.8079,-63.22411506,51.09896668,-1.929996,3.054133656,84.84130744,26884200
35.59,38.09,35.040001,37.400002,3140500,7354749.423,0.824397039,2144546.223,38.09,34.080002,86.03242349,45.0597009,-23172.49061,-13.32042471,67.77143521,1.310002,7.656879237,102.1694348,30024700
37.16,39.950001,37.029999,37.939999,2539200,7263908.682,0.992135497,2879955.116,39.950001,34.080002,70.44114271,66.44358285,22171.3727,-29.0883068,69.58766022,2.649998,5.359625402,29.33326542,32563900
37.779999,38.439999,37.110001,37.849998,955000,845846.6487,1.105068562,876879.4608,39.950001,34.080002,69.1175984,75.19705487,16147.90024,-30.8824016,68.89082397,2.849998,4.876691604,-4.652555911,31608900
38.189999,38.189999,37.029999,37.330002,796400,-68460.87055,1.139474348,-313192.9236,39.950001,34.080002,61.47059728,67.00977946,3027.789113,-38.52940272,64.85021106,2.010002,5.780677082,-6.470933647,30812500
37.52,37.939999,36.68,37.240002,886400,-347566.9859,1.146265498,-860375.1245,39.950001,37.240002,44.80653768,58.46491112,1107.724924,-39.85293233,64.14891345,2.260002,6.400005714,55.07347796,29926100
37.330002,37.970001,36.529999,36.580002,1028600,-937506.4951,1.085873772,-1193714.494,39.950001,36.580002,1.462075168,35.91307004,-14601.83385,-49.55881611,59.10142825,1.620003,3.567389581,41.0393528,28897500
36.700001,38.470001,36.669998,38.009998,1098100,249377.5389,1.140257442,-843916.18,38.470001,36.580002,76.2885296,40.85238082,25608.49434,-28.52946008,65.44547343,2.859996,8.662086907,8.123276881,29995600
35.27,35.490002,34.689999,35,4481800,-164913.8466,0.929757544,-755917.2034,38.470001,35,8.201080317,28.65056169,-61349.64766,-72.79414306,48.42000637,0.599998,0.11441934,690.4409171,25513800
35.099998,35.439999,34.41,34.48,1509400,-2656902.246,0.712758962,-1444103.276,38.470001,34.48,1.724137506,28.73791581,-127936.3905,-80.44120301,46.18468865,0.399998,-1.906122224,148.5836627,24004400
34.099998,34.290001,33.099998,33.150002,1655700,-2804497.078,0.428526512,-1641313.818,38.470001,33.150002,0.931172664,3.618796829,-186158.5187,-99.27001492,40.97442591,-4.25,-3.633720719,216.9410413,22348700
33.150002,33.849998,32.099998,32.459999,1847700,-2305762.571,0.145910803,-1414092.259,38.470001,32.459999,5.651504403,2.768938191,-220621.2004,-95.41400175,38.54494385,-5.48,-4.753529651,57.84213224,20501000
33.240002,33.290001,32.009998,33.09,1105500,218780.5664,-0.026918072,-389320.4173,35.490002,32.459999,31.03450456,12.53906054,-184760.0518,-86.39796484,41.93045453,-4.759998,-11.5240689,-64.79859895,21606500
33.77,34.48,32.919998,33.439999,1033900,869569.9653,-0.134098403,272366.5464,35.439999,32.459999,41.6909791,26.12566269,-173066.9755,-81.98991864,43.78331225,-3.890003,-11.86083321,-59.28245117,22640400
33.939999,34.040001,32.849998,33.59,649600,83420.90192,-0.204577518,268157.7345,34.48,32.459999,63.96764051,45.56437472,-168429.2352,-80.100738,44.59918389,-3.650002,-11.25494908,-31.97905759,23290000
33.41,33.700001,32.09,32.25,1099600,-579328.7355,-0.364359418,31183.08726,34.48,32.25,9.716672294,38.45843064,-194343.6144,-96.97730593,39.13508893,-4.330002,-13.60836252,38.07132094,22190400
32.43,33.07,32.040001,32.240002,1115500,-1490182.699,-0.486189984,-358413.0828,34.48,32.240002,9.311895294,27.6654027,-194684.5075,-96.43956822,39.0966011,-5.769996,-13.42642248,25.84611913,21074900
32.09,32.75,31.530001,32.66,823100,193585.9859,-0.542596541,50534.25476,34.48,32.240002,38.30506383,19.11121047,-180152.6297,-83.71759366,41.69085495,-2.34,-10.71624326,-19.97861171,21898000
32.75,33.43,32.5,33.16,774900,1155844.668,-0.540720237,519410.0866,34.040001,32.240002,64.9401992,37.51905278,-167551.5887,-76.51298271,44.71027039,-1.32,-12.75979546,-29.43265641,22672900
33.139999,33.73,32.939999,33.16,821800,-125683.6992,-0.533088144,256244.8023,33.73,32.240002,74.09089731,59.11205345,-167551.5887,-76.51298271,44.71027039,0.009998,-5.257142857,-81.6636173,22672900
32.860001,32.970001,31.709999,31.940001,890800,-935453.4448,-0.618355363,-132362.715,33.73,31.940001,18.63637211,52.55582287,-197786.6664,-94.09221902,38.99595055,-0.519998,-7.366586427,-40.98317212,21782100
31.82,32.200001,31,31.82,674500,-183808.7641,-0.687686109,-40145.87238,33.73,31.82,30.03663004,40.92129982,-201133.4694,-81.7372019,38.47505982,-1.27,-4.012072156,-59.26194359,21107600
32.07,32.990002,32.07,32.91,712200,875814.1008,-0.647216623,338381.5541,33.73,31.82,69.96336996,39.54545737,-178028.3468,-56.98197229,45.58508859,-0.529999,1.38632475,-61.45478162,21819800
32.959999,33.52,32.91,33.490002,425300,762076.0032,-0.561866108,426282.329,33.73,31.82,91.20886447,63.73628816,-165476.6171,-28.44821839,48.96478567,-0.099998,1.208830462,-61.52872004,22245100
33.599998,33.630001,32.91,33.34,591000,241847.6947,-0.500558985,257961.6088,33.630001,31.82,88.9733502,83.38186154,-167381.5394,-32.75862069,48.13216444,1.09,-0.299040081,-42.83779863,21654100
33.27,33.360001,32.580002,33.130001,413900,121684.8368,-0.463574019,127418.4404,33.630001,31.82,80.98860038,87.05693835,-171104.0772,-38.79307471,46.92904105,0.889999,-1.369452218,-36.283867,21240200
33.130001,34.209999,33.130001,33.779999,659000,271565.5602,-0.377462608,110120.2435,34.209999,32.91,79.90653267,83.28949442,-162983.5168,-20.11497126,51.01086287,1.119999,4.744182946,-40.06911604,21899200
33.5,34.389999,33.389999,33.939999,497300,215698.5665,-0.292931301,75256.91553,34.389999,33.130001,75.13808034,78.6777378,-159862.1432,-13.2743402,51.98973034,0.779999,5.272943221,-55.41909458,22396500
33.91,34,32.130001,32.459999,841300,-365478.7971,-0.341427499,-130766.963,34.389999,32.459999,14.60169434,56.54876911,-181547.5887,-56.93217019,43.35929445,-0.700001,-0.612372933,2.211152958,21555200
32.32,32.459999,31.4,31.83,1247500,-620221.9989,-0.425788514,-284216.2082,34.389999,31.83,14.38127571,34.7070168,-197875.9367,-75.51621697,40.29304107,-0.110001,-4.010856454,60.98851465,20307700
31.959999,32.580002,31.610001,32.470001,1158000,659546.1521,-0.435976825,86045.89487,34.389999,31.83,35.78599859,21.58965621,-172792.6427,-56.63712585,44.58062773,0.650001,-2.08081725,40.91019713,21465700
32.5,32.73,29.370001,30.190001,3097200,1062927.865,-0.620871065,358043.1278,34.389999,30.190001,16.33466786,22.16731406,-254105.8524,-83.66533214,34.95140076,-2.719999,-5.479022997,247.6874719,18368500
30.299999,30.77,29.76,30.059999,1947900,-586581.2074,-0.769026301,-88078.44777,34,30.059999,14.9027678,22.34114475,-267442.7911,-86.25501444,34.49390458,-3.430003,-5.531115651,188.7916976,16420600
32.970001,34.68,32.400002,32.959999,5556300,-1865039.238,-0.644999477,-669357.6976,34.68,30.059999,67.60826132,32.94856566,-79521.62719,-32.39173868,50.16474309,-0.380001,0.151926466,680.1600674,21976900
32.490002,33.439999,32.16,32.25,1221300,-2105599.796,-0.597115139,-922845.0505,34.68,30.059999,54.23727952,45.58276954,-199211.177,-45.76272048,47.18835356,-0.880001,-3.702603541,187.1620033,20755600
31.92,32.130001,30.049999,30.059999,1380900,-2385962.341,-0.727495123,-1031855.682,34.68,30.059999,12.99431506,44.94661863,-282146.0056,-87.00568494,39.41925175,-3.72,-9.838035393,133.6548223,19374700
30.26,30.959999,29.219999,29.43,1585700,-2421774.981,-0.871610471,-994040.8089,34.68,29.43,3.846171457,23.69258868,-311086.9786,-96.15382854,37.50623116,-4.509999,-11.16812825,283.1118628,17789000
29.58,30.18,28.879999,29.18,1257100,-1651190.916,-0.994531494,-643017.9031,34.68,29.18,5.172430143,7.337638888,-324557.0771,-94.82756986,36.74417909,-3.279999,-13.61752261,90.75872534,16531900
29.299999,29.790001,28.24,28.57,1149000,-1115072.35,-1.128164414,-270378.2705,33.439999,28.57,6.346155067,5.121585555,-350836.4123,-94.8757764,34.88185482,-3.26,-15.82203641,131.0476573,15382900
28.370001,28.459999,26.83,27.559999,1616500,-237707.5277,-1.300575877,185806.5928,32.130001,27.559999,13.77356344,8.430716216,-391455.6335,-90.70064968,31.99072564,-4.910002,-15.09550262,92.14311185,13766400
27.58,29.26,27.120001,28.77,1475200,2383795.751,-1.32431041,1189650.845,30.959999,27.559999,46.97337699,22.36436517,-320484.4184,-75.2866242,38.56068797,-1.420001,-9.613572102,18.25250501,15241600
30.1,31.34,30,30.799999,2366200,3035711.512,-1.165876742,1699592.067,31.34,27.559999,88.02658537,49.59117527,-216394.932,-49.42676433,47.69064765,0.74,-5.143215117,104.3350604,17607800
30.559999,31.049999,29.5,31.02,1220400,2770800.711,-1.010911519,1669406.216,31.34,27.559999,92.90465632,75.96820623,-199493.426,-46.62420382,48.58240721,-1.939999,2.749251317,-60.59666796,18828200
31.25,31.25,29.690001,30.280001,1075600,1797189.824,-0.937010919,1195507.974,31.34,27.559999,76.49669623,85.80931264,-228606.7329,-56.05094268,45.7567789,-1.969999,0.731876272,-44.78155963,17752600
30.16,30.41,29.200001,29.809999,757000,52197.34599,-0.905926438,337733.0897,31.34,28.77,63.74404354,77.71513203,-245302.0478,-62.0382293,44.00611689,-0.25,-9.557039125,-86.37582564,16995600
30.01,31.93,30.01,31.690001,1650000,2652148.159,-0.721276883,783379.2509,31.93,29.809999,91.20882462,77.1498548,-197560.9689,-38.08915924,51.92884432,2.260001,-1.736431008,35.10194056,18645600
31.08,31.42,30.24,30.41,1307200,1669101.933,-0.67049709,581685.3132,31.93,29.809999,44.32232393,66.42506403,-264206.6484,-54.39490446,47.04782669,1.23,1.164341356,-5.337098993,17338400
30.07,30.290001,28.75,29.5,1118700,-631504.5015,-0.695663953,-285717.4645,31.93,29.5,23.58490566,53.03868474,-303323.7809,-59.60665047,43.88935707,0.93,0.237852531,-29.45071577,16219700
28.530001,29.16,27.76,28.15,885800,-28433.35378,-0.815146093,-422703.4661,31.93,28.15,9.352517986,25.75324919,-354518.5267,-75.09434432,39.6380146,0.590001,-3.529814942,-29.53623419,15333900
28.030001,28.41,27.110001,27.879999,1030900,79920.39333,-0.921006584,-405839.414,31.93,27.879999,15.97506555,16.30416307,-363014.686,-79.41178431,38.82793544,-0.890001,-2.415124256,-10.27850305,14303000
27.84,28.389999,27.559999,27.91,630900,229458.3816,-0.991056671,-314465.7224,31.42,27.879999,18.56146602,14.62968319,-361905.3592,-78.82352941,38.97716779,-2.889999,1.269960133,-60.97123415,14933900
28.200001,29.450001,28.139999,29.219999,909900,678895.9793,-0.93014378,-105494.9109,30.290001,27.879999,66.35213836,33.62955665,-332293.0923,-53.13727451,45.2571336,-1.800001,1.564125826,-38.32022777,15843800
29.809999,29.870001,28.85,28.93,492100,408801.4602,-0.8949539,-96355.57033,29.870001,27.879999,65.94199275,50.28519905,-341323.5543,-58.82352941,44.17336729,-1.350001,-6.071425522,-79.20294143,15351700
28.860001,30.190001,28.15,30.08,881100,1238876.338,-0.765446684,180257.5819,30.190001,27.879999,96.42853896,76.24089003,-321762.0265,-38.3817507,49.35288515,0.270001,-3.03030303,-27.80235988,16232800
30.309999,31,28.959999,29.120001,636000,1168656.521,-0.731838994,254687.786,31,27.91,45.34888217,69.23980463,-349882.2099,-58.29874654,45.55338732,-2.57,-3.830911366,-40.87021197,15596800
29.23,29.84,28.809999,29.66,569000,-100142.0036,-0.654091294,-141725.5508,31,28.93,53.14686953,64.97476355,-338088.2761,-47.09544546,47.97941496,-0.75,-0.503183512,-24.8348745,16165800
29.549999,30.639999,29.469999,29.77,844100,9781.235326,-0.576948893,-256034.9261,31,28.93,56.84210526,51.77928565,-335978.0266,-44.81328731,48.48298511,0.27,-6.058696559,-48.84242424,17009900
30.18,30.65,28.620001,29.389999,872200,-244206.495,-0.540248245,-360336.2278,31,29.120001,43.50873684,51.16590388,-346752.5931,-52.69712712,46.79765276,1.239999,-3.354163104,-33.27723378,16137700
29.389999,29.950001,28.809999,29.91,646800,819011.4244,-0.463855938,-31950.49255,31,29.120001,54.20166143,51.51750118,-331320.6473,-41.90872239,49.39024697,2.030001,1.389830508,-42.18289086,16784500
29.940001,32.330002,29.5,31.84,1256800,3412088.167,-0.244758195,930363.5894,32.330002,29.389999,86.79240248,61.50093358,-289584.6393,-9.387009696,57.6408995,3.93,13.10834813,41.88304358,18041300
32.02,32.66,31.5,32.09,911100,2813156.095,-0.050368132,1048889.728,32.66,29.389999,85.89108562,75.62838318,-279716.5488,-10.27027212,58.582794,2.870001,15.10043454,-11.62091376,18952400
33.5,34.5,33.209999,33.779999,3422400,130443.3939,0.237320506,148433.6775,34.5,29.389999,87.75508295,86.81285702,-231734.0593,-9.742910655,64.35320951,4.849999,21.03188463,442.4631479,22374800
34.259998,34.279999,31.84,32.189999,1891900,-917768.3741,0.333175473,-566950.6038,34.5,29.91,59.40245002,77.68287286,-392823.9397,-31.25847514,56.39264102,2.109999,10.1642714,107.9239477,20482900
32.599998,33.98,32.459999,33.790001,3046600,2712802.89,0.532114134,347114.9202,34.5,31.84,85.80002,77.65251766,-298787.1619,-10.23053167,61.5473927,4.67,16.79917387,519.1018086,23529500
33.939999,34.119999,32.75,33.110001,1498500,3105890.651,0.627668765,814568.293,34.5,32.09,53.6667,66.28972334,-360097.8437,-21.85532675,58.388407,3.450001,10.07314162,70.07150153,22031000
32.049999,32.349998,31.389999,31.610001,2613900,-2005082.65,0.575722463,-694471.2223,34.5,31.610001,7.074017018,48.84691234,-427985.1869,-45.51179528,52.04289749,1.840001,8.550823882,310.990566,19417100
31.9,32.450001,31.57,31.959999,1047200,-1614506.717,0.556382923,-1124397.662,34.279999,31.610001,19.72318339,26.82130014,-399043.0881,-40.00001575,53.31772342,2.57,7.754548213,84.04217926,20464300
31.9,32.110001,30.620001,31.41,914100,117999.7548,0.491015751,-646806.6311,34.119999,31.41,22.5714129,16.45620444,-417064.3325,-52.55102935,51.0224204,1.5,5.508901579,8.292856297,19550200
32.799999,32.799999,31,31.290001,1125800,-325242.7397,0.424633964,-533659.5822,34.119999,31.290001,19.14286808,20.47915479,-420556.567,-54.59182901,50.51149317,-0.549999,6.464790965,29.07590002,18424400
31.35,31.799999,30.190001,30.4,1315600,-1485663.179,0.296789077,-808082.3308,32.799999,30.4,8.045944863,16.58674195,-452578.3981,-69.72790301,46.77065441,-1.69,1.638248078,103.4013605,17108800
30.6,31,30.4,30.66,947000,-1158139.253,0.213984233,-742671.9942,32.799999,30.4,18.00763832,15.06548375,-441326.556,-65.30613356,47.98263228,-3.119999,-3.706030151,-24.64990452,18055800
30.809999,31.67,30.799999,31.23,1253800,-385383.0978,0.192140162,-402520.6258,32.799999,30.4,39.84673551,21.9667729,-423720.8808,-57.46923419,50.63624734,-0.959999,-2.679962605,37.61387334,19309600
30.99,31.73,30.799999,30.99,784500,-570139.1152,0.153690931,-285561.0147,32.799999,30.4,30.65132617,29.5019,-433356.2314,-70.2,49.4914186,-2.800001,-8.259322329,-77.07748948,18525100
30.940001,31.83,30.67,31.49,910500,4569.959603,0.161701465,-28891.83047,31.83,30.4,79.26828004,49.92211391,-420698.9226,-69.83760321,51.92978262,-1.620001,-2.174585342,-51.87377768,19435600
31.540001,32.48,30.889999,31.27,758400,190785.2619,0.148584916,137986.053,32.48,30.66,41.82692308,50.58217643,-427059.9896,-74.94201275,50.76842906,-0.340001,-7.457830498,-75.10667629,18677200
31.57,31.68,31.01,31.51,638600,-131686.8842,0.155760441,91105.31758,32.48,30.99,46.40883978,55.83468097,-421239.2029,-67.72617004,52.02880961,-0.449999,-4.8323798,-57.38405072,19315800
31.290001,33.009998,30.799999,32.700001,1125700,2138197.252,0.254536098,785880.395,33.009998,30.99,86.75225363,58.32933883,-397121.95,-36.13228302,57.79796408,1.290001,3.448275753,-56.93408317,20441500
32.970001,34.400002,32.830002,34.25,1304800,3709079.396,0.452670381,1498489.027,34.400002,31.27,95.97850082,76.37986474,-343763.1176,-3.562992028,63.88958569,2.959999,7.165209861,24.59893048,21746300
34.32,36,33.900002,35.959999,1744000,5287564.166,0.739155333,2156029.619,36,31.27,99.23075015,93.9871682,-278618.3966,-0.688485489,69.17575517,5.559999,14.48582935,90.78875397,23490300
35,35.209999,32.380001,33.349998,2569300,4362969.512,0.746980725,1934831.597,36,31.51,49.03843288,81.41589461,-405199.0937,-45.61105776,55.7588607,2.689998,6.583563228,128.2199325,20921000
31.42,33.669998,31.059999,32.150002,2881900,2266490.18,0.648872952,1001386.11,36,32.150002,25.96159116,58.07692473,-497647.3668,-66.26503722,50.87332669,0.920002,5.756585526,119.0559441,18039100
32.720001,33.150002,32.040001,32.27,1435900,654818.3579,0.574185815,15682.27561,36,32.150002,24.49394241,33.16465548,-486890.8438,-64.19966682,51.33254132,1.28,5.251141553,51.62618796,19475000
32.07,32.25,31.25,31.790001,1568500,-682634.0317,0.470836305,-814538.8967,36,31.790001,14.77736543,21.74429967,-508249.0888,-72.46126893,49.3455439,0.300001,1.793150817,25.09969692,17906500
31.049999,31.299999,30.620001,30.66,1386800,-1124271.579,0.29435628,-1220646.878,35.209999,30.66,0.871438288,13.38091538,-564002.6752,-95.35714286,44.93573688,-0.61,-1.064859632,76.77501593,16519700
30.66,31.040001,29.620001,29.84,1500300,-2187550.427,0.087320862,-1614130.06,33.669998,29.84,5.432078098,7.026960605,-601092.5643,-96.55173927,42.0023778,-1.67,-5.239758654,64.77759473,15019400
29.92,29.98,28.75,28.950001,2842200,-2749404.217,-0.146878555,-1807133.017,33.150002,28.950001,4.545475207,3.616330531,-645840.0677,-97.24136552,39.02472815,-3.75,-7.419248481,274.7626582,12177200
29.9,30,27.639999,28.129999,2262300,-2495666.874,-0.394107562,-1641069.343,32.25,28.129999,10.62906494,6.868872748,-726344.7172,-94.13875668,36.46008208,-6.120001,-10.72675659,254.2593173,9914900
28.709999,29.66,28.1,29.51,1673000,1514006.247,-0.473228698,-148140.998,31.299999,28.129999,51.0929235,22.08915455,-615360.8433,-77.63156966,43.22265284,-6.449999,-9.755354442,48.61863729,11587900
29.51,30.25,27.209999,27.35,2065200,517103.2234,-0.702132965,158873.3629,31.040001,27.35,3.655376681,21.79245504,-737816.9598,-98.40726981,36.64797871,-5.999998,-20.1459854,58.27713059,9522700
27.540001,27.969999,27.35,27.42,1575100,-2967970.234,-0.867888354,-838859.8953,30.25,27.35,6.907925359,20.55207518,-732531.256,-97.6109104,36.98252236,-4.730002,-23.74860745,-9.684633028,11097800
27.99,27.99,26.030001,26.25,1592300,-2350277.605,-1.081196554,-974224.9465,30.25,26.25,5.213247681,5.258849907,-799740.1181,-97.79338995,33.77236511,-6.02,-21.2893506,-38.02592146,9505500
26.84,26.85,25.52,26.1,1305100,-1042269.409,-1.247962848,-524851.2283,30.25,26.1,12.26215645,8.127776496,-808838.9753,-94.46564885,33.37241348,-5.690001,-18.81804549,-54.71390402,8200400
26.9,27.549999,26.74,27.27,1209500,243936.565,-1.271065068,115944.578,30.25,26.1,36.99788584,18.15776332,-750334.4925,-81.94014262,39.40068746,-3.39,-15.49426712,-15.7671147,9409900
27.549999,28.700001,27.549999,28.27,1528200,751828.4917,-1.194907947,529149.8775,28.700001,26.1,86.47796023,45.24600084,-705981.7239,-66.25766043,44.05938939,-1.57,-11.07266716,-2.569333758,10938100
28.77,30.9,28.5,30.25,2387200,4059957.947,-0.963674784,1702670.52,30.9,26.1,87.91821561,70.46468723,-598948.2609,-38.00787995,51.93798915,1.299999,-1.337247228,72.13729449,13325300
29.9,30,28.59,29.09,1308900,3340765.603,-0.864062764,1799124.989,30.9,26.1,66.35687732,80.25101772,-690490.4758,-46.95393759,47.69948145,0.960001,-2.513404826,-12.75744851,12016400
29.52,30,29.129999,29.41,672600,-458102.9014,-0.750645224,466295.931,30.9,27.27,64.18269231,72.81926175,-676092.1258,-32.69895029,48.93744278,-0.1,1.58894295,-76.33523327,12689000
29.309999,29.940001,29.309999,29.940001,707400,177861.5772,-0.610951684,81009.47479,30.9,28.27,71.34332199,67.29429721,-663971.1237,-19.92753262,51.00594441,2.590001,6.434418999,-68.73093754,13396400
29.690001,31.299999,29.1,31.17,870100,2195355.787,-0.396423188,557957.7663,31.299999,29.09,95.35717691,76.96106374,-634909.6252,-2.249118036,55.51023284,3.75,5.625211793,-47.9916318,14266500
30.75,31.17,29.26,29.42,793400,1149699.199,-0.363428803,369640.6289,31.299999,29.09,30.62731757,65.77593883,-683760.2829,-32.52593988,48.65629984,3.17,7.568555759,-61.58241333,13473100
29.389999,29.700001,28.809999,29.4,525400,-467107.9633,-0.335032304,-255440.5362,31.299999,29.4,23.69481928,49.89310459,-684299.6439,-32.8719607,48.58247151,3.3,7.221006565,-66.64338772,12947700
29.530001,30.389999,29.5,30.299999,669000,600432.779,-0.237171511,-148261.637,31.299999,29.4,59.83935743,38.05383143,-668215.9883,-17.30104106,52.10436797,3.029999,15.42856762,-57.98530428,13616700
30.290001,30.709999,29.98,30.01,508200,-4521.47029,-0.180930964,-283422.836,31.299999,29.4,48.19281124,43.90899598,-674618.9367,-22.31832566,50.89467029,1.74,14.98084291,-61.06045514,13108500
30.15,30.389999,29.1,29.51,1179100,-792985.0362,-0.174692005,-563825.1124,31.17,29.4,29.66104675,45.89773848,-683086.1143,-30.96884619,48.79135776,-0.74,8.214154749,-2.513435304,11929400
29.58,30,29,29.110001,761600,-914962.4731,-0.199721892,-666089.3088,30.709999,29.110001,15.78957895,31.21447898,-699068.4532,-37.88924531,47.11389049,0.020001,2.971351256,-50.16359115,11167800
29.01,30.040001,29.01,29.950001,775500,67162.22857,-0.150047623,-334876.8651,30.709999,29.110001,55.55564652,33.66875741,-677091.6762,-29.60522579,50.92927808,0.540001,-0.991732231,-67.51424263,11943300
30,30.85,29.65,30.73,1471000,2102788.705,-0.047196949,478761.8195,30.85,29.110001,93.51351351,54.95291299,-656895.0417,-15.19997333,54.23119442,0.789999,5.637676177,12.38444495,13414300
30.059999,30.24,29.41,29.5,1429400,295821.1807,-0.064197737,193145.9945,30.85,29.110001,27.02702703,58.69872902,-715773.3365,-64.28570153,48.66962495,-1.67,0.306018361,112.5185846,11984900
29.57,29.700001,28.17,28.32,1350400,-2161206.749,-0.1709169,-723037.1838,30.85,28.32,5.597014925,42.04585182,-772949.3365,-95.2076662,44.00698975,-1.1,-5.410824803,90.89623975,10634500
28.4,29.379999,28,28.690001,1402700,-748932.0023,-0.223065259,-582748.5933,30.85,28.32,24.2105614,18.94486779,-755306.351,-79.09087245,45.76162043,-0.709999,-7.956365095,61.21135502,12037200
28.49,28.639999,28.02,28.41,838900,282482.9398,-0.283716443,-144203.1799,30.85,28.32,14.38596491,14.73118041,-768996.0474,-87.57575381,44.62204586,-1.889999,-3.433038749,5.734812201,11198300
28.6,28.74,28.1,28.41,656400,-119005.2376,-0.328001941,-79435.09631,30.24,28.32,18.30357143,18.96669925,-768996.0474,-87.57575381,44.62204586,-1.6,-3.367346939,24.93338409,11198300
28.610001,28.84,28.200001,28.52,539800,-232137.2115,-0.350185714,-81714.22689,29.700001,28.32,30.5882173,21.09258455,-766454.5479,-83.59621451,45.24331668,-0.99,-5.874584352,-19.31240658,11738100
28.52,28.99,27.9,28.139999,752500,-503378.331,-0.393888913,-161522.025,29.379999,28.139999,16.21615961,21.70264945,-773646.8529,-91.86444068,43.43065335,-0.970002,-6.23125958,48.07162534,10985600
28.01,28.5,27.809999,27.940001,639300,-841953.5863,-0.439594804,-287215.3395,28.99,27.940001,11.01710931,19.27382874,-778995.0584,-95.72361983,42.4663075,-2.01,-5.320227042,-45.78068018,10346300
28,28.9,27.9,28.549999,841700,-183231.9002,-0.421733827,-102931.5827,28.99,27.940001,62.71181126,29.98169339,-765037.5885,-75.65790274,46.37717903,-2.180001,-1.923744352,10.51733193,11188000
28.549999,29.57,28.5,29.35,953200,866743.2699,-0.339116357,315897.6522,29.57,27.940001,87.5000071,53.74297589,-741452.2692,-49.34208903,51.07433362,-0.15,-2.00334217,22.91424887,12141200
29.200001,29.35,27.299999,27.370001,1483300,-714580.3894,-0.428471634,-44629.52074,29.57,27.370001,3.083787188,51.09853518,-805756.7001,-98.02811323,41.40679462,-0.949999,-10.93393752,0.836165874,10657900
27.76,28.16,27.4,27.799999,1014900,-1403599.798,-0.459294627,-407294.1288,29.57,27.370001,22.02642201,37.53673877,-782453.2288,-85.91549693,43.89069548,-0.890002,-5.762715254,-28.99818105,11672800
27.9,28.58,27.799999,28.280001,1145200,34454.32928,-0.439918811,-61067.50707,29.57,27.370001,43.17187525,22.76069482,-764929.7019,-72.39431764,46.61149209,-0.129999,-0.141239407,-15.19549763,12818000
28.57,29.5,28.48,29.48,1484700,1564827.02,-0.323998593,573059.0132,29.57,27.370001,96.03524404,53.74451377,-716335.6847,-25.85033134,52.77660356,1.07,2.753569092,5.845868682,14302700
30,30.65,29.65,30.389999,1536600,2193153.162,-0.156893105,980300.0882,30.65,27.370001,92.23877844,77.14863258,-670505.4434,-7.761221564,56.84624764,1.869999,6.96937346,83.16843486,15839300
32.349998,32.779999,31.51,32.540001,3212800,3439613.414,0.147328085,1454381.509,32.779999,27.799999,95.5390698,94.60436409,-561795.5657,-4.379525547,64.60693247,4.400002,14.53713833,389.4576478,19052100
31.879999,31.9,30.68,31.34,1788500,3061507.668,0.288272492,1395801.034,32.779999,28.280001,71.08435743,86.28740189,-680276.3,-26.27735401,58.30446355,3.399999,9.887798036,231.3264172,17263600
31,31.74,30.940001,31.049999,1048500,-429541.6077,0.372279883,134156.8852,32.779999,29.48,59.7674325,75.46361991,-696825.9742,-31.56934307,56.86086115,2.5,10.34115175,39.33554817,16215100
30.93,31.5,30.68,30.9,912400,-1255882.544,0.421889401,-657093.0086,32.779999,30.389999,39.936115,56.92930164,-701891.158,-34.30655109,56.08731893,1.55,10.59412632,42.71859847,15302700
31.1,31.49,29.540001,30.02,1870000,-978976.6567,0.38574997,-832944.0002,32.779999,30.02,14.8147931,38.1727802,-727875.3651,-50.36494526,51.64812477,2.649999,5.148865329,122.169419,13432700
29.51,31.030001,29.4,30.66,1301900,832775.1691,0.404093721,-252694.3703,31.9,30.02,50.4,35.0503027,-688008.6096,-38.68611314,54.47049739,2.860001,4.463373083,36.58203945,14734600
28.620001,29.48,27.530001,27.66,5680400,-3218392.996,0.17454431,-1281355.359,31.74,27.66,3.087862966,22.76755202,-815396.0852,-93.43063869,42.07307833,-0.620001,1.059550564,282.9569204,9054200
27.66,28.4,27.48,27.540001,1527200,-5899227.879,-0.016863773,-2438677.284,31.5,27.540001,1.492562189,18.32680839,-840039.6976,-95.62040146,41.66459144,-1.939999,-0.935244638,50.47787959,7527000
27.82,28.540001,27.6,28.49,1758600,135644.8627,-0.090851796,-770242.4464,31.49,27.540001,25.18703242,9.922485858,-787358.5639,-78.28465328,46.12420978,-1.899999,0.742570695,53.56269647,9285600
28.73,29.889999,28.610001,29.280001,4343400,2311789.665,-0.084764249,674730.8286,31.030001,27.540001,50.70423924,25.79461128,-738594.2341,-65.055737,49.57635355,-3.26,-0.678422659,192.5439483,13629000
29.5,29.889999,29,29.16,884400,256277.4269,-0.088601558,550490.4718,29.889999,27.540001,69.70957249,48.53361472,-756395.2015,-68.30188081,49.06209301,-2.18,-4.047380851,-42.44435767,12744600
29.280001,29.889999,29,29.799999,729000,-74422.47588,-0.039544241,344397.5866,29.889999,27.540001,96.26555862,72.22645678,-736984.5322,-56.2264257,51.92624325,-1.25,-8.420411542,-77.30951195,13473600
29.75,29.950001,29.24,29.299999,1052800,-391185.5598,-0.040544415,127989.7353,29.950001,28.49,72.3403522,79.43849444,-749216.0762,-65.66038975,49.58070361,-1.600001,-6.509256541,-41.13502935,12420800
30,30.1,28.65,29.4,1541300,-488766.5089,-0.032888694,-3224.663582,30.1,29.16,53.0201027,73.87533784,-745622.8661,-63.77357807,50.06651398,-0.62,-5.314006612,47.00047687,13962100
29.700001,29.809999,28.68,28.889999,938600,-155166.3884,-0.067199663,49535.3628,30.1,28.889999,16.55165517,47.30403669,-772359.7553,-68.09957014,47.55015109,-1.770001,-6.504857605,2.871547567,13023500
28.860001,29.4,28.610001,29.25,889700,-166589.0096,-0.06459764,62981.32477,30.1,28.889999,42.95298185,37.50824657,-760663.7722,-58.45070423,49.48035663,1.59,-2.564956696,-52.42245989,13913200
29.120001,29.120001,28.25,28.370001,1193000,-484809.384,-0.132022212,-38495.5667,30.1,28.370001,6.486540541,21.99705919,-787430.7845,-77.86067164,45.11019799,0.83,-7.469011742,-8.364697749,12720200
28.389999,28.719999,28.01,28.4,503600,-915856.159,-0.180950123,-213660.4901,30.1,28.370001,18.66028708,22.69993649,-786169.2828,-77.05735661,45.28760036,-0.09,2.675343456,-91.13442715,13223800
28.940001,28.98,28.25,28.32,450600,-406420.0391,-0.223603613,-103801.8761,29.809999,28.32,17.22223179,14.1230198,-787587.8743,-76.33803483,44.87111236,-0.960001,2.832240275,-70.49502357,12773200
28.32,28.73,27.5,27.639999,987600,-1112777.815,-0.308718494,-274173.3831,29.4,27.639999,7.368368421,14.41696243,-798407.3817,-93.89316794,41.38700574,-1.520001,-2.983506494,-43.84169226,11785600
28.02,28.049999,26.860001,27.33,1468700,-935265.9725,-0.396615047,-262464.9239,29.120001,27.33,20.79641593,15.12900538,-809483.9021,-85.49385355,39.86724153,-2.469999,-6.659839253,-66.18547682,10316900
27.67,28.09,27.34,28.059999,479300,127584.9436,-0.402726501,104365.1849,28.98,27.33,56.60370595,28.25616343,-770254.1352,-62.96301326,44.9899636,-1.24,-3.772294239,-45.80506558,10796200
28.25,28.84,27.799999,28.82,668000,994437.4081,-0.34229834,520760.9968,28.98,27.33,92.45282663,56.6176495,-757272.3642,-39.50618503,49.78608666,-0.58,-3.288587359,-8.367626886,11464200
28.99,28.99,27.780001,28.040001,741000,279397.7986,-0.353275646,416250.2261,28.99,27.33,55.39908704,68.15187321,-775351.4528,-63.58023567,45.41019723,-0.849998,-4.300334618,-29.6162614,10723200
27.83,28.200001,27.299999,27.74,1027400,-462175.2307,-0.38178187,99699.83556,28.99,27.33,41.31452644,63.05548004,-783279.439,-72.83952865,43.81507046,-1.51,-5.646258503,-33.34198404,9695800
27.99,28,27.360001,27.85,470200,47135.72982,-0.390990087,123191.8145,28.99,27.74,32.54441861,43.0860107,-779205.3943,-69.44446588,44.58372957,-0.520001,-3.599858207,-49.90411251,10166000
27.379999,28.559999,27.370001,28.389999,749000,777172.5548,-0.350671931,353887.358,28.99,27.74,64.49700326,46.11864944,-770088.4273,-52.77782493,48.32146921,-0.010001,-2.940174359,-15.81431943,10915000
28.52,28.52,27.25,27.42,1016400,-50580.13453,-0.392466208,152715.3739,28.99,27.42,9.770114943,35.6038456,-795679.455,-81.01697018,42.7443096,-0.9,-3.348611091,-14.8030176,9898600
27.799999,27.799999,27.450001,27.52,577700,-1129281.025,-0.412761255,-286688.4823,28.559999,27.42,20.61070276,31.62594032,-791972.6717,-74.01577717,43.46870432,-0.119999,-3.098591549,14.71405878,10476300
27.530001,27.799999,27.02,27.379999,477400,-506920.9135,-0.435126272,-242358.3442,28.559999,27.379999,23.37657362,17.91913044,-794911.5735,-76.99123894,42.65504455,0.049999,-3.319212571,5.947625388,9998900
27.700001,28.35,27.370001,28.129999,775200,329926.6458,-0.387860957,64078.96698,28.559999,27.379999,72.07790395,38.68839344,-781834.5094,-40.37565276,48.24412793,0.07,1.772793118,-21.50668287,10774100
28.25,29.49,28.200001,29.25,1024100,1299898.587,-0.257064851,492241.7603,29.49,27.379999,90.28340081,61.91262613,-750969.7812,-9.125478755,55.25722871,0.43,7.025246981,-30.27166882,11798200
29.27,29.549999,28.549999,28.92,1030300,616897.6562,-0.177984541,405331.5379,29.549999,27.379999,75.09884391,79.15338289,-762523.7299,-23.42005459,52.97931635,0.879999,3.064864685,114.9593157,10767900
29.799999,31.58,29.33,31.5,2048900,4105387.283,0.091813246,1442903.006,31.58,27.379999,98.24561404,87.87595292,-670608.9996,-1.694915613,65.09454602,3.76,9.299097849,206.7215569,12816800
30.610001,31.200001,29.950001,31.15,2324000,7069099.039,0.274226746,2679190.256,31.58,28.129999,89.78622085,87.71022627,-693374.5552,-9.429824561,62.73312903,3.3,11.09129418,213.6302294,10492800
31,32.049999,30.809999,31.540001,1714500,3242269.753,0.445129406,1723753.881,32.049999,28.92,86.75329182,91.59504224,-664277.8513,-10.13912726,64.28776074,3.150002,13.69863374,66.87755499,12207300
31.01,31.879999,30.940001,31.309999,1274000,245277.8297,0.555607063,222600.3076,32.049999,28.92,78.85714286,85.13221851,-676780.6546,-14.71173255,62.62845332,3.889999,12.42369479,170.9485325,10933300
30.6,30.93,29.85,30.32,863000,-382981.2918,0.556857649,-611644.9934,32.049999,30.32,36.3970722,67.33583563,-717063.5919,-34.39362513,55.93610405,2.8,6.798172131,15.22029372,10070300
30.290001,31.42,30.16,31.07,555900,269627.1481,0.611320556,-689674.9317,32.049999,30.32,55.45457066,56.90292857,-695716.2964,-19.48308538,59.46955806,3.690001,13.3114515,-45.30696576,10626200
31.290001,32,30.719999,31.610001,998300,935772.8162,0.690101312,-446943.1092,32.049999,30.32,80.00008182,57.28390823,-686054.6757,-8.747476888,61.84212623,3.480002,14.86192224,72.80595465,11624500
31.959999,32.119999,31.200001,31.379999,871300,40322.95589,0.725611986,-591928.4002,32.119999,30.32,67.4008667,67.61850639,-693318.5475,-14.50980677,60.22502908,2.129999,14.60920433,82.50942606,10753200
31.299999,31.440001,30.5,30.82,984000,-878139.16,0.700492372,-889666.8379,32.119999,30.32,42.73129636,63.37741496,-708867.5324,-25.49018147,56.3607475,1.9,9.562748296,26.93498452,9769200
31.15,32,30.59,31.84,908700,698618.4734,0.754196464,-428894.512,32.119999,30.82,85.71432945,65.28216417,-676301.6661,-5.490177547,61.23920001,0.34,8.854700855,-11.26843082,10677900
32.07,33.25,31.84,32.919998,1392400,2210666.495,0.873831176,279699.8567,33.25,30.82,87.99992727,72.14851769,-645478.9844,-5.612279866,65.62147371,1.769998,13.83125173,35.14510337,12070300
32.799999,33.099998,31.91,33,922500,2105911.801,0.963985811,510821.0723,33.25,30.82,90.90909091,88.20778254,-642095.1815,-4.95049603,65.92876988,1.459999,4.761904762,-54.9758407,12992800
32.610001,33.470001,32.290001,32.470001,963200,285110.2253,0.981355069,-20413.57467,33.470001,30.82,66.32997767,81.74633195,-656911.0627,-20.32519499,61.97642093,1.160002,4.237563403,-58.55421687,12029600
32.599998,32.830002,31.700001,32.130001,430300,-724423.8535,0.956657421,-557096.4485,33.470001,31.84,53.47223838,70.23710232,-666996.9262,-32.36714194,59.51168112,1.810001,1.870640397,-74.90230388,11599300
32.099998,32.299999,31.620001,32.27,495800,218867.9725,0.937573344,-425865.0933,33.470001,32.130001,35.13508108,51.64576571,-665121.9942,-33.14918974,60.21331896,1.2,3.066116355,-61.08320251,12095100
32.130001,32.66,31.52,32.150002,910800,466740.9012,0.902364346,-254595.8713,33.470001,32.130001,32.3077783,40.30503259,-666965.6573,-36.4640507,59.26529898,0.540001,6.035626649,5.538818076,11184300
32,34.290001,31.91,33.23,1525200,1500317.15,0.95064928,167479.0597,34.290001,32.130001,61.7328297,43.05856303,-636369.635,-23.87389102,64.65846683,1.850001,6.952043772,174.3658931,12709500
33.439999,34,32.869999,33.689999,1103400,1936057.525,1.014340824,463565.3726,34.290001,32.130001,78.3392858,57.4599646,-615256.4699,-13.51355551,66.68185338,2.869999,6.580189605,10.52789743,13812900
33.630001,34.279999,33.009998,33.82,1420300,1238092.63,1.063052617,320469.5458,34.290001,32.150002,83.032461,74.36819217,-610998.7344,-11.38016674,67.2524727,1.98,7.775656717,63.00929645,15233200
33.889999,35,33.5,34.619999,2085700,2443611.184,1.152920151,616370.8342,35,32.150002,89.08043103,83.48405928,-577402.0881,-8.444466667,70.59043671,1.700001,12.32965282,111.9613821,17318900
34.080002,34.799999,33.549999,33.900002,1263300,1340189.012,1.152754839,330298.7761,35,33.23,64.40135922,78.83808375,-620778.685,-24.4444,64.24357862,0.900002,6.469855528,39.0227798,16055600
33.82,34.189999,33.580002,33.709999,661500,-901948.3128,1.124331579,-530165.1944,35,33.689999,39.4366012,64.30613049,-627859.2389,-28.66668889,62.64291767,1.239998,2.39976017,-52.49209997,15394100
33.82,34.799999,33.5,33.900002,660400,-627571.6415,1.104406682,-746674.6783,35,33.709999,44.72377415,49.52057819,-624130.761,-24.94326531,63.61909301,1.770001,2.727278788,-28.41192412,16054500
34.299999,34.490002,33.849998,34.169998,664400,-312631.5831,1.097748319,-667159.0233,35,33.709999,44.66653333,42.94230289,-618871.0163,-23.85063218,65.01797594,1.899998,5.235592694,-31.02159468,16718900
34.43,34.799999,34.18,34.57,929800,-101896.9393,1.111930692,-506927.1393,34.799999,33.709999,82.30775562,57.2326877,-611093.3943,-12.35632184,67.03999232,2.419998,7.594145422,116.0818034,17648700
34.599998,35.5,34.459999,35.279999,1572600,974562.56,1.16700876,-52783.60611,35.5,33.709999,88.99995,71.99141298,-591997.1527,-5.527663317,70.31938137,2.049999,9.327545708,217.1843485,19221300
35.209999,35.799999,34.950001,35.259998,2063800,285511.7187,1.195266326,-81442.55511,35.799999,33.900002,76.52168544,82.60979702,-592888.6939,-12.61684874,70.10776444,1.569999,9.673392866,126.592007,17157500
35.259998,35.299999,32.75,33.610001,2151300,-246995.9543,1.072160483,-255197.0616,35.799999,33.610001,28.19676334,64.5727996,-689464.5306,-51.16818953,55.31808834,-0.209999,1.143547999,41.05035405,15006200
33.779999,34.400002,33.59,33.810001,1023000,-95728.79818,0.9794461,-254948.2589,35.799999,33.610001,34.75414254,46.49086378,-676662.9838,-46.49529124,56.51554043,-0.809998,0.356194727,-7.286568787,16029200
33.77,34.5,33.75,34.400002,824900,-93884.36537,0.942710453,-231082.4966,35.799999,33.610001,54.09844397,39.01644995,-658811.1351,-35.98964935,59.92732912,0.5,1.714967475,-41.92072097,16854100
34.259998,35.07,34.259998,34.59,1553900,18164.93468,0.918342361,-164659.6805,35.799999,33.610001,60.32788863,49.72682505,-654255.0496,-39.67211137,60.98882436,0.880001,-0.086652227,-25.49743491,18408000
34.75,35.259998,34.52,34.610001,1298800,-1431979.605,0.890380631,-583927.2747,35.299999,33.610001,72.94124429,62.45585896,-653356.5369,-39.01634066,61.10562465,0.709999,2.094392207,2.81010053,19706800
34.509998,34.790001,34.049999,34.43,921200,-1122036.821,0.843967452,-603743.3796,35.259998,33.810001,50.29946144,61.18953145,-660111.385,-44.91801473,59.38248241,0.260002,2.135867758,39.25925926,18785600
33.939999,34.169998,33.580002,34,1492400,98699.13573,0.763683993,-168548.22,35.259998,34,24.99994048,49.41354873,-671616.3516,-59.01638001,55.36586686,-0.57,0.294979334,125.984252,17293200
33.639999,34.349998,33.549999,34.279999,375800,438245.5282,0.714416997,132846.2174,35.259998,34,42.69008344,39.32982845,-659326.0425,-49.83608191,57.38709691,-1,0.321922758,-43.43768814,17669000
33.959999,34.5,33.5,33.59,601400,-251696.0714,0.61263334,24540.14035,35.259998,33.59,5.113642175,24.2678887,-666890.2675,-72.45900736,51.23033318,-1.669998,-2.834827885,-35.31942353,17067600
33.5,33.91,33,33.689999,561100,-241640.7271,0.533883862,-18798.38531,34.790001,33.59,38.54740863,28.78371142,-665099.8716,-69.18035055,52.03350434,0.079998,-4.506802849,-64.32023401,17628700
33.380001,33.650002,33.02,33.220001,414100,51688.24438,0.428608687,58513.10744,34.5,33.220001,14.66673333,19.44259471,-672927.5916,-84.5901261,48.02986697,-0.59,-5.78558456,-79.93507123,17214600
33,33.970001,33,33.869999,594900,256412.3163,0.393095401,149960.6403,34.5,33.220001,57.99993333,37.07135843,-664825.1182,-63.27870927,53.37315275,-0.530003,0.773573318,-72.34695301,17809500
35,35.450001,34.709999,35.360001,1194800,1087540.614,0.479652439,438188.122,35.450001,33.220001,96.32653211,56.33106626,-638654.4003,-14.42616866,62.81196452,0.770001,4.584442337,16.79374389,19004300
35.18,35.450001,34.75,34.77,742000,-74650.76146,0.494936052,146475.9159,35.450001,33.220001,72.24486847,75.52377797,-658590.2933,-25.18521289,57.8206512,0.159999,1.075575519,-10.04970299,18262300
34.799999,34.799999,33.919998,34.400002,674000,-688798.3248,0.471754585,-181587.4764,35.450001,33.220001,57.14291545,75.23810534,-666486.1379,-42.85708455,54.87566307,-0.029998,-0.549285921,-56.62526546,17588300
34.799999,34.799999,33.900002,34.34,442000,-14270.55154,0.443429862,-84664.8021,35.450001,33.869999,54.69385523,61.36054638,-667661.7584,-45.30614477,54.39184134,0.34,-0.780124219,-65.96858639,17146300
34.5,34.5,33.110001,33.68,1284000,-57021.71188,0.363535223,-50920.45889,35.450001,33.68,24.35893162,45.39856743,-676156.8079,-72.24490929,49.24832697,-0.599999,-2.178332849,39.38341294,15862300
34.009998,34.189999,33.400002,33.639999,698000,-344022.7613,0.293605894,-123805.3379,35.450001,33.639999,22.64948718,33.90075801,-677681.7866,-73.8776025,48.94622262,0.049999,-1.058826471,-53.22969713,15164300
33.869999,33.990002,33.380001,33.529999,922500,-875719.2856,0.226697093,-311543.0155,34.799999,33.529999,24.85198207,23.95346696,-679964.1886,-78.36739658,48.07290469,-0.16,-2.187864708,145.4763172,14241800
34.040001,34.040001,32.110001,32.91,1563200,-221969.8031,0.122233615,-152011.5014,34.799999,32.91,29.73976189,25.74707705,-697022.0202,-76.04793413,43.37527846,-0.310001,-2.024412027,159.9268374,12678600
33.080002,33.380001,32.849998,33.259998,925100,505146.5215,0.066916103,158425.8124,34.5,32.91,48.11704942,34.23626446,-680397.3811,-65.5689521,46.55054808,-0.610001,-1.276346135,64.87257173,13603700
33.110001,34.25,33.080002,33.900002,1624200,1015804.496,0.073868045,433502.6316,34.25,32.91,83.64494563,53.83391898,-662596.1864,-46.40715569,51.86586881,-1.459999,2.046962611,292.2241005,15227900
33.849998,34.23,33.73,34.099998,1378200,997567.8818,0.094427019,500822.1683,34.25,32.91,92.99055747,74.91751751,-653014.0777,-40.4192515,53.42458225,-0.670002,0.679064089,131.6691881,16606100
34.16,34.849998,33.919998,34.380001,1436700,86410.48187,0.131794808,192918.9726,34.849998,32.91,82.84680604,86.49410305,-641697.3576,-32.03592814,55.59275097,-0.020001,-2.771493134,20.24606629,18042800
34.740002,34.779999,33.82,34.52,3555100,1460549.868,0.170737642,486646.6543,34.849998,33.259998,83.5001,86.44582117,-635846.9632,-27.84434132,56.67863971,0.18,-0.719010641,379.1239892,21597900
34.560001,35.549999,34.259998,35.189999,1920200,2775651.685,0.252749895,981008.8609,35.549999,33.900002,85.42508351,83.92399652,-566845.9944,-10.46512236,61.52726307,1.509999,2.296502773,184.8961424,23518100
35.02,36.240002,34.959999,36,1564300,2583484.126,0.378739632,1032921.098,36.240002,34.099998,90.43817495,86.45445282,-522646.9616,-5.811185034,66.42040587,2.360001,4.834012813,253.9140271,25082400
36,37.720001,35.84,36.990002,1970400,2834428.826,0.552107938,1040102.046,37.720001,34.380001,81.28208172,85.71511339,-479628.6247,-13.01245989,71.23570947,3.460003,9.827796912,53.45794393,27052800
37,37.540001,36.799999,36.98,1287800,758118.0983,0.680848099,287840.652,37.720001,34.52,81.02562025,84.24862564,-480161.4157,-13.19074866,71.12473978,4.07,9.928659629,84.49856734,25765000
36.860001,38.709999,36.860001,38.029999,1986000,850880.8797,0.857714548,-16554.54689,38.709999,35.189999,84.71910456,82.34226884,-443596.0097,-10.30303343,75.44858277,4.770001,13.42081758,115.2845528,27751000
38.099998,38.439999,37.130001,37.950001,1426600,2229825.673,0.980128996,299180.2646,38.709999,36,79.73338667,81.82603716,-447773.6598,-11.5151247,74.53285436,4.049999,15.31449711,-8.738485159,26324400
37.849998,38,37.43,37.52,968100,-91913.48238,1.030566117,-337588.8858,38.709999,36.98,58.53660576,74.329699,-463938.0711,-18.03029334,69.64013583,3.420002,12.80818477,4.648146146,25356300
37.869999,37.869999,36.93,37.509998,901400,-550521.2555,1.057540156,-713316.1129,38.709999,36.98,37.17272251,58.48090498,-464196.1451,-18.18183884,69.52580836,3.129997,10.64895512,-44.50190863,24454900
38.169998,38.5,37.619999,38.299999,1100600,675862.5197,1.129641946,-411962.767,38.709999,37.509998,77.83781388,57.84904738,-445211.6893,-6.996585837,73.25985861,3.779999,12.3167192,-20.14221448,25555500
38.400002,38.419998,37.59,37.740002,1128000,-256668.4431,1.128586414,-547945.0894,38.5,37.509998,51.59248408,55.53434016,-461303.9272,-17.22908556,66.99339274,2.550003,9.773126534,-21.48674045,24427500
38,38.650002,37.68,38.130001,1310200,-867722.9631,1.146009078,-748187.4695,38.650002,37.509998,69.76741888,66.39923894,-449647.36,-11.64654852,68.98322177,2.130001,10.45770857,-63.14590307,25737700
38.18,39.389999,37.900002,39.169998,1893200,2012037.858,1.229562104,154199.7698,39.389999,37.509998,91.05686628,70.80558974,-413911.6129,-3.949749363,73.56062651,2.179996,11.31002874,-1.406103531,27630900
39.189999,39.68,38.950001,39.48,1196600,2431182.446,1.305741278,642704.212,39.68,37.740002,90.43062201,83.75163572,-398928.3141,-3.412969283,74.75651065,2.5,9.666666667,-23.50572141,28827500
39.450001,40,39.139999,39.240002,1139800,-586917.1371,1.331400433,-176185.13,40,37.740002,68.46481328,83.31743386,-406202.4176,-13.24037866,72.03983091,1.210003,6.082724732,-42.15387739,27687700
37.98,39.150002,37.5,38.419998,3266300,666615.1228,1.270917681,-96317.31173,40,38.130001,36.79992,65.2317851,-430020.9831,-31.34923981,63.54311749,0.469997,3.893991347,153.6341047,24421400
38.450001,38.869999,37.290001,37.889999,2261300,1514088.219,1.166768395,214762.5364,40,37.889999,22.14015577,42.46829635,-475079.1774,-50.72117788,58.72225469,0.369999,-0.368130433,13.86203424,22160100
38.299999,39,38.049999,38.450001,966800,-218807.5544,1.116545969,-228877.3205,40,37.889999,42.80444384,33.91483987,-441657.8906,-48.43745361,62.00252896,0.940003,1.317523022,-32.23047806,23126900
38.639999,38.75,38.209999,38.27,990700,-994180.3761,1.05011469,-636268.8579,40,37.889999,36.16233807,33.70231256,-446183.8975,-55.09555895,60.34260472,-0.029999,1.998933902,2.33446958,22136200
38.5,38.509998,36.950001,37.040001,2017600,-2540793.377,0.887980695,-1237190.545,39.150002,37.040001,4.090907231,27.68589638,-478025.0265,-96.41690554,50.4110139,-0.700001,-1.252991269,123.8295984,20118600
37.360001,39.290001,37.310001,39.279999,2701400,3588490.658,0.929522497,579676.4613,39.290001,37.040001,99.5725641,46.60860313,-356010.4519,-23.4528013,62.51187004,1.149998,2.558746803,145.4479375,22820000
39.299999,39.650002,38.459999,38.540001,3122000,2645759.749,0.892445464,970282.5419,39.650002,37.040001,58.88886708,54.1841128,-406902.2709,-47.55697068,57.51837021,-0.629997,2.119764064,176.7730496,19698000
36.490002,37.389999,34.540001,35.16,9037800,-4130603.62,0.583596479,-1114247.183,39.650002,35.16,12.13305046,56.86482721,-680705.1471,-88.64470488,41.29312509,-4.32,-7.789144826,589.8030835,10660200
35.720001,36.389999,35.599998,36.110001,2547300,-1071959.207,0.410753661,-892509.1038,39.650002,35.16,30.72406444,33.91532733,-436509.4975,-71.24541598,45.91142519,-3.130001,-7.812093838,34.54996831,13207500
36.150002,36.75,34.34,34.380001,2889400,-2329565.338,0.132648848,-1120808.286,39.650002,34.380001,0.753314217,14.53680971,-558548.5138,-99.29326855,39.77506541,-4.039997,-12.9179306,141.4674912,10318100
34.459999,34.959999,33.799999,34.43,2762900,-2247590.403,-0.082762682,-1086228.809,39.650002,34.380001,10.76924234,14.082207,-554346.4455,-89.83869519,40.02456129,-3.459999,-12.25790457,142.4021758,13081000
34.41,35.41,34.400002,35.099998,1959200,1248361.141,-0.197142101,139013.6322,37.389999,34.380001,36.21167131,15.91140929,-500581.198,-79.03227758,43.40785765,-3.350003,-8.641333089,-40.0177571,15040200
35.889999,36.099998,34.369999,34.830002,1964900,231511.0425,-0.306047114,304068.3605,36.75,34.380001,34.9153441,27.29875258,-515651.7448,-83.38705107,42.3705695,-3.439998,-8.076001797,-13.10750453,13075300
35,35.080002,34.25,34.650002,1546600,-721183.0149,-0.402242813,40818.24368,36.75,34.380001,28.81365125,33.31355555,-525806.2662,-85.47004164,41.65589644,-2.389999,-9.882962032,59.97103848,11528700
34.77,35.830002,34.700001,35.580002,1757700,975300.8419,-0.398837816,469204.5828,36.099998,34.43,77.39146843,47.04015459,-484295.7924,-69.57261389,46.66173794,-3.699997,-7.028999216,77.42000606,13286400
36,36.919998,35.790001,36.650002,2087000,2454070.854,-0.306268797,1072316.309,36.919998,34.650002,89.88778269,65.36430079,-431436.3518,-51.28202498,51.7871463,-1.889999,-1.052913039,3.439730373,15373400
37.009998,37.880001,36.970001,37.689999,1150000,1884049.716,-0.147290246,1040190.17,37.880001,34.650002,94.76578657,87.34834589,-372214.6978,-33.5043076,56.19333226,2.529999,-4.04786161,-57.42948101,16523400
37.73,38.650002,36.880001,38.23,1158300,1876737.123,0.022021122,930158.182,38.650002,34.650002,90.45450434,91.7026912,-355738.1479,-24.27352601,58.3231481,2.119999,-0.804361681,-62.89878283,17681700
38.060001,39.439999,37.360001,38.470001,912100,1875928.982,0.173566906,800328.1253,39.439999,35.580002,79.53589854,88.25206315,-348466.5507,-20.17094692,59.27093232,4.09,9.414109784,-89.9079422,18593800
38.869999,39.439999,38.650002,39.099998,1579500,618056.4321,0.340577557,274226.5522,39.439999,36.650002,90.68489901,86.89176729,-333529.7104,-9.401772956,61.73113167,4.669998,8.28024624,-37.99316924,20173300
38.900002,39.380001,38.849998,39.119999,1275100,-250264.4596,0.469140654,-242210.4253,39.439999,37.689999,87.49999023,85.90692926,-332721.7416,-5.673758865,61.81000195,4.020001,13.7870793,-55.86973074,21448400
39,39.490002,38.810001,38.98,822000,-758006.0837,0.553352384,-593015.1214,39.490002,38.23,80.45970097,86.2148634,-337284.9504,-8.96312357,60.86444148,4.149998,13.21521929,-70.24865178,20626400
38.900002,38.91,36.77,36.849998,2021000,-2260536.862,0.443109535,-1160693.643,39.490002,36.849998,2.941100779,56.96693066,-382201.873,-46.39723389,48.6661883,2.199996,4.98575527,3.154348714,18605400
36.639999,36.650002,35.209999,35.290001,3279600,-4618795.794,0.227243046,-2037763.276,39.490002,35.290001,1.869204297,28.42333535,-467758.2939,-73.81368692,42.02335757,-0.290001,1.320697599,66.90925747,15325800
35.299999,36.060001,34.919998,35.150002,1316100,-3582880.134,0.044359204,-1881703.755,39.490002,35.150002,5.032905879,3.281070318,-480768.7985,-82.82439587,41.47620217,-1.5,1.44300136,-14.90365964,14009700
35.25,35.599998,34.939999,35.080002,1098500,-1459545.076,-0.105015421,-971190.636,39.490002,35.080002,3.501178555,3.46776291,-483389.7656,-84.16027322,41.18743852,-2.609997,-1.405283788,-37.50355578,12911200
35.259998,36.07,35.16,35.950001,1423000,224838.4283,-0.151448436,25522.26721,38.91,35.080002,25.81459859,11.44956101,-456146.4974,-67.55724521,46.20075488,-2.279999,-1.909961697,-31.81600383,14334200
35.950001,37.060001,35.740002,36.009998,1146300,334188.2084,-0.181315585,465741.3606,37.060001,35.080002,50.93450804,26.75009506,-453771.651,-72.65142533,46.53919821,-2.460003,-4.457418532,-0.32173913,15480500
36.200001,36.799999,36.200001,36.619999,440200,-549513.7473,-0.15398845,322312.971,37.060001,35.080002,79.4391877,52.06276478,-434353.5953,-62.80088595,49.98429819,-2.479999,-4.211354957,-61.99602866,15920700
37.099998,38.52,36.77,37.529999,2378800,514985.7984,-0.058230855,573040.9425,38.52,35.080002,72.34634851,67.57334808,-423414.7092,-42.88843073,54.67658467,-1.59,-2.443467574,160.8047363,18299500
37.98,38.220001,37.66,37.860001,1808200,-338607.2827,0.043781447,351919.0466,38.52,35.950001,80.35717262,77.38090294,-402497.8752,-35.66738672,56.27847691,-1.119999,-3.171347988,14.47926559,20107700
37.939999,38.380001,37.310001,38.16,1296300,34553.11846,0.147138226,348200.3035,38.52,36.009998,87.0503504,79.91795717,-388169.8727,-29.10286293,57.74072359,1.310002,-2.453985237,1.662614697,21404000
38.23,38.240002,37.75,37.889999,1158700,169893.7885,0.204900429,358087.3669,38.52,36.619999,72.84477278,80.0840986,-397341.8406,-35.01097592,55.92778445,2.599998,-2.796308363,40.96107056,20245300
42.360001,46.68,41.700001,43.93,14098500,22988893.34,0.72964411,7590169.444,46.68,37.529999,72.25025227,77.38179181,-212634.8112,-23.38434976,74.9077876,8.779998,19.21303225,597.6001979,34343800
43.599998,45.5,43.509998,44.34,6652400,25298051.37,1.165159597,10593465.17,46.68,37.860001,75.02667823,73.37390109,-81053.09028,-19.8979558,75.67363141,9.259998,25.64465498,102.84181,40996200
43.099998,43.470001,40.209999,41.099998,5643600,2563661.401,1.234635564,3625374.328,46.68,37.889999,40.44821136,62.57504729,-567155.6907,-47.44898853,60.07059014,5.149997,16.92744143,328.8124003,35352600
41.110001,42.25,40.810001,42.009998,2264800,3260216.235,1.347590973,666843.3086,46.68,37.889999,47.7043449,54.39307817,-442200.0642,-39.71089461,62.41462653,6,19.75483354,106.1720528,37617400
42,42,40.5,41.369999,1552400,3038860.544,1.369677588,-674518.3106,46.68,41.099998,17.92889986,35.36048537,-476703.035,-45.15306205,59.75765095,4.75,15.07648915,9.093464512,36065000
41.970001,42.549999,41.509998,41.830002,1679000,73485.47422,1.40806845,-2105465.74,45.5,41.099998,30.62386945,32.08570474,-459441.5249,-41.31173413,61.04137266,4.300003,16.16218918,46.47125534,37744000
41.799999,41.830002,40.330002,40.5,1696100,-1840635.925,1.316003371,-3108485.975,43.470001,40.5,8.895730739,19.14950001,-512826.0157,-53.64583333,55.52616865,2.639999,10.59530613,285.3021354,36047900
40.700001,42.009998,40.610001,41.860001,2121100,1208574.357,1.33736553,-2266019.529,42.549999,40.5,68.91896701,36.14618906,-455870.5171,-44.05849983,59.5507388,3.700001,11.53744235,-10.83319321,38169000
42.060001,44.549999,41.75,43.59,3447400,7585369.439,1.47686725,313607.8635,44.549999,40.5,77.25119236,51.68863004,-368209.2464,-29.48473564,64.0120578,5.700001,15.13470377,90.65368875,41616400
43.25,45.139999,43.049999,43.75,3149400,5271258.718,1.582096606,604092.2163,45.139999,40.5,71.10187387,72.42401108,-355555.3349,-29.56609485,64.40310005,-0.18,14.64884696,142.9530201,44765800
43.5,43.799999,42.509998,43.299999,1681400,786610.383,1.610614152,-758924.311,45.139999,40.5,61.74633789,70.0331347,-387949.2355,-36.07258656,62.35104696,-1.040001,14.27817404,45.11090015,43084400
44.189999,46.139999,43.91,45.59,3180400,5235272.247,1.797280523,167954.4584,46.139999,41.860001,90.05426403,74.30082526,-299025.2685,-11.63287211,67.94791406,4.490002,3.778738903,-77.4415718,46264800
45.5,45.950001,44.540001,45.450001,2118500,5735263.352,1.911879264,690951.6285,46.139999,43.299999,84.28250211,78.69436801,-308791.7265,-13.77378499,67.28932846,3.440003,2.503385205,-68.15435031,44146300
45.98,47.599998,45.389999,46.970001,3367900,5537806.648,2.101130366,779264.0987,47.599998,43.299999,87.62284872,87.31987162,-237942.0031,-8.524994388,70.6190318,5.600002,14.28224644,-40.32355234,47514200
47.459999,49.880001,47.07,47.830002,3011700,4452964.973,2.294063584,399372.84,49.880001,43.299999,72.18455678,81.36330254,-176277.1679,-21.19957162,72.33491657,6,13.8538545,32.97862946,50525900
48.599998,50.200001,47.75,50.189999,3939400,9687801.858,2.607340782,1873286.076,50.200001,45.450001,99.84098572,86.54946374,-27675.81591,-0.1001201,76.4068856,9.689999,21.31979747,153.761917,54465300
51,52.919998,50.66,51.009998,3733800,7747312.77,2.888485621,1688523.501,52.919998,45.450001,77.20762907,83.07772386,36685.69286,-15.17077527,77.63846025,9.149997,21.94596118,122.3823705,58199100
50.900002,51.049999,48.98,50.43,2630000,1177034.524,3.029570932,-631106.4033,52.919998,46.970001,66.93229309,81.32696929,-5768.66153,-19.77759167,74.66941988,6.84,24.51851852,55.06161193,55569100
50.5,52.400002,50.5,52,2795900,6631008.572,3.230824997,212682.7784,52.919998,47.830002,84.27353308,76.13781841,76109.18896,-7.307373251,77.21004452,8.25,24.22359952,31.81368158,58365000
53.130001,53.740002,50.619999,51.200001,3622100,2757303.171,3.28786658,-694008.1635,53.740002,50.189999,57.59599079,69.60060565,33095.39657,-18.9410962,73.18217708,7.900002,17.45813489,5.067587167,54742900
51.759998,54.990002,51.200001,54.939999,3639700,12716516.72,3.593436134,2167005.142,54.990002,50.43,99.1680036,80.34584249,297678.3359,-0.347725984,78.76058762,9.349999,25.57714057,15.56804471,58382600
56,58.18,53.759998,53.990002,5522600,9599450.773,3.716108403,2148625.497,58.18,50.43,54.45654348,70.40684596,234742.3303,-25.50211808,74.52028356,8.540001,24.68822921,228.4524801,52860000
55.990002,55.990002,53,53.279999,2742800,-5682968.924,3.713231926,-2916811.125,58.18,51.200001,36.19790365,63.27415024,162116.614,-31.26994496,71.42526986,6.309998,16.86773196,-13.75927556,50117200
53.849998,55.27,53.700001,54.110001,3050400,-2721103.215,3.734873228,-3781458.733,58.18,51.200001,46.16404151,45.60616288,204844.2703,-25.9731875,72.84511097,6.279999,19.05390497,43.98867123,53167600
56.470001,56.470001,54.5,54.549999,3378700,-4127150.549,3.744365562,-4238787.931,58.18,53.279999,47.99424756,43.45206424,229648.7404,-25.43798879,73.59416604,4.36,16.1379558,0.320674604,56546300
56.389999,59.66,55.5,59.5,4366700,14174833.67,4.104003618,1782825.824,59.66,53.279999,97.5975976,63.91862889,536240.2837,-1.058201128,80.20847228,8.490002,24.39890761,44.99120098,60913000
62,62.369999,55.119999,55.509998,9991000,11741775.53,4.020711296,3309983.331,62.369999,53.279999,26.78760158,57.45981558,243414.3722,-40.40047703,65.88296372,5.079998,10.59971928,153.6173021,50922000
57.5,58.200001,55.709999,55.790001,6769900,-11567856.84,3.931970128,-3782879.2,62.369999,54.110001,24.10611859,49.49710592,293810.8786,-43.00652569,66.33733674,3.790001,9.370717874,81.3139429,57691900
70.120003,75.769997,63.689999,69.400002,28605000,142239934.8,4.903332881,42598236.13,75.769997,54.549999,70.05173532,40.31515183,1945331.655,-22.73374619,80.16509005,18.200001,37.61650208,987.6425856,86296900
69.650002,81,69.25,76.760002,25082600,327570014.7,6.195616145,116668423.6,81,55.509998,83.61670079,59.2581849,4978945.401,-13.24171768,83.99410779,21.820003,47.61538846,797.120784,111379500
80.989998,88,79.150002,87.800003,22416900,372718915.8,8.018167316,150729203.1,88,55.509998,99.39173664,84.35339091,8586448.291,-0.512549974,87.79890782,33.810001,71.48437751,518.8923553,133796400
94.220001,97.120003,81.150002,83.239998,37163900,238771764.8,8.990955814,108340955.4,97.120003,55.790001,66.48151736,83.16331826,7422198.034,-29.77263858,79.40296351,29.959999,51.51073811,921.0704179,96632500
81.800003,86.879997,78.110001,84.839996,16878700,155039535.2,9.778286178,54509057.84,97.120003,69.400002,63.26651053,76.37992151,8136544.106,-26.40861493,80.12126694,30.729995,57.14019792,205.6295948,113511200
94.699997,95,88.660004,92.25,21614000,177886398.6,10.87481842,34801005.55,97.120003,76.760002,82.52600475,70.75801088,9610745.431,-10.60540677,83.06658062,37.700001,73.14189514,688.0268339,135125200
92.5,94.440002,87.5,91.5,19002200,136177883.4,11.55016626,10304001.56,97.120003,83.239998,70.43659964,72.07637164,9435021.854,-12.73799324,81.74638313,32,69.09997839,522.9412536,116123000
91.120003,92.5,88.629997,89.940002,8348400,73372872.02,11.82321483,-20637640.2,97.120003,83.239998,62.23040376,71.73100272,9111050.335,-16.27379989,78.93618985,34.430004,64.876267,147.0891171,107774600
88.5,89.989998,85.279999,87.589996,8998200,21614738.67,11.71493942,-47887932.42,95,84.839996,56.12786004,62.93162115,8892918.362,-21.94842598,74.76649495,31.799995,47.21007731,106.0640758,98776400
86.370003,90.959999,85.5,87.239998,8568000,25271501.91,11.4686846,-53518815.26,95,87.239998,20.16459669,46.17428683,8856962.749,-23.18161498,74.13836084,17.839996,57.16087397,-14.24281854,90208400
84.809998,93.010002,83.050003,92.730003,12022200,125107685.4,11.58300177,-19190953,94.440002,87.239998,84.98683801,53.75976492,9396146.196,-10.45237996,77.35245337,15.970001,66.2125853,77.5831253,102230600
92.599998,97.949997,92,97.080002,16124200,195590248.2,11.88757495,19023165.42,97.949997,87.239998,94.16110503,66.43751325,9960112.079,-2.031274902,79.52390683,9.279999,39.88472508,-43.63153295,118354800
101.550003,110.75,100.300003,110.330002,19691900,276271620.5,13.04770978,58598180.95,110.75,87.239998,98.48376157,92.54390154,12160829.48,-0.763077748,84.42307628,27.090004,43.73371434,-21.49179112,138046700
113.550003,114.900002,99,104.629997,25099500,321816332.9,13.35325423,83952352.07,114.900002,87.239998,67.75508533,86.79998398,11143482.19,-20.05468541,75.99891282,19.790001,19.16855743,11.96686429,112947200
102.459999,109.540001,101.199997,104.949997,16133700,176720069.9,13.46599412,40525488.19,114.900002,92.730003,68.75979494,78.33288061,11220246.41,-21.79628601,76.14284032,12.699997,26.08121038,-56.58771012,129080900
106.260002,106.440002,97.730003,97.760002,15172000,36957433.3,12.82730363,-25394112.15,114.900002,97.080002,25.15284496,53.88924174,10114946.5,-46.58874568,66.49432027,6.260002,15.22867351,-10.11156072,113908900
97.620003,97.620003,88.25,92.589996,19139600,58126663.57,11.76830286,-43317001.55,114.900002,92.589996,16.285162,36.73260064,9312580.202,-60.64149332,60.55260789,2.649994,0.36855935,-11.44813547,94769300
92.75,96.419998,92.400002,94.839996,8856100,90919330.58,10.98397687,-36277153.03,114.900002,92.589996,24.72793811,22.05531503,9777685.525,-54.52570115,62.13824559,7.25,3.650268852,-53.39434381,103625400
93.660004,97.970001,89.110001,95.370003,12224800,91067929.39,10.28658269,-30052010.55,109.540001,92.589996,33.44294347,24.8186812,9827177.25,-61.3186801,62.52042222,8.130005,6.037359216,46.43284941,115850200
95.25,99.269997,95.110001,97.349998,9510900,89854601.5,9.780913539,-25159419.27,106.440002,92.589996,50.02747113,36.06611757,10080978.68,-55.10205511,63.9830619,4.619995,11.14282732,5.697806228,125361100
98,102.900002,96.699997,102.040001,10711600,72628923.12,9.647401898,-26351582.39,102.900002,92.589996,94.12968681,59.20003381,10539182.59,-40.3767705,67.24389539,4.959999,16.96469892,25.01867414,136072700
98.93,102.519997,98.57,100.050003,9228600,63601753.61,9.274110579,-27315968.29,102.900002,94.839996,79.33285864,74.49667219,10330283.5,-46.62480209,64.57252679,-10.279999,7.893885219,-23.23701153,126844100
98.18,98.68,94.050003,94.470001,7394000,4269762.352,8.430829636,-44105580.81,102.900002,94.470001,38.86874265,70.77709603,9815584.803,-64.14443216,57.655946,-10.159996,-2.688505301,-54.14346138,119450100
96.800003,100.480003,95.75,97.730003,9192700,9239176.419,7.934118747,-45383283.2,102.900002,94.470001,41.5819256,53.26117563,10070739.4,-53.90894675,60.32944569,-7.219994,-11.42028349,-53.31735384,128642800
99,99.279999,95.120003,98.18,5961600,29523077.36,7.490437683,-35326258.13,102.900002,94.470001,46.66663804,42.37243543,10113067.11,-62.7392148,60.69831734,0.419998,-6.164577258,-76.24813243,134604400
100,102.519997,99.330002,100.300003,6564700,18465326.86,7.226580249,-31518917.75,102.519997,94.470001,73.78989879,54.01282081,10241796.08,-54.78423229,62.46887524,7.710007,-4.430675686,-59.3106355,141169100
103.599998,104.75,101.199997,102.199997,7066200,3789710.638,7.089066622,-31765527.5,104.75,94.470001,76.16818958,65.54157547,10366151.91,-47.65479943,64.03276618,7.360001,4.541729653,-53.42604798,148235300
101.75,103.980003,99.199997,103.389999,8795300,37757183.44,6.995469875,-18170805.83,104.75,97.730003,85.87745147,78.61184661,10448429.72,-28.88680935,65.01601693,8.019996,11.66433035,-54.04658405,157030600
102.059998,106.669998,102.010002,104.68,8578900,55008830.96,6.945324699,-5468276.771,106.669998,98.18,82.77057263,81.60540456,10558169.02,-10.8034648,66.09797378,7.330002,10.3753737,-3.130045957,165609500
104.650002,107.129997,99.449997,100.650002,10106500,22842622.44,6.505406846,-10009374.25,107.129997,100.300003,18.28505675,62.31102695,10227896.28,-34.32201287,59.86866671,-1.389999,5.536330957,-17.32789084,155503000
103.699997,103.699997,97.5,99.550003,11718600,19779768.83,5.998856964,-11931697.16,107.129997,99.550003,21.28768057,40.78110331,10117442.84,-42.06434896,58.25484415,-0.5,2.259892188,23.21231429,143784400
96.5,102.870003,95.300003,101.489998,7119800,58952863.59,5.688381791,830764.2668,107.129997,99.550003,52.32458275,30.63244002,10345810.74,-31.29855856,60.28800128,7.019997,-0.539007247,-33.53187199,150904200
103.099998,104.199997,100.550003,102.400002,5848700,50709394.52,5.45290006,3353325.212,107.129997,99.550003,60.01692816,44.54306383,10409650,-36.16205787,61.24158374,4.669999,2.348824517,-36.62419002,156752900
103.800003,105.870003,102.660004,105.720001,6602600,27831201.28,5.47110774,-3198990.903,107.129997,99.550003,88.08117739,66.80756277,10599275.76,-10.77979088,64.58297914,7.540001,11.90854227,-10.70327292,163355500
106.75,110.25,106.129997,109.25,8744900,45056966.51,5.704619572,-107741.2058,110.25,99.550003,93.31103545,80.46971366,10819737.08,-6.172840649,67.7650521,8.949997,11.78757459,-4.871256541,172100400
108.57,109.440002,106.709999,107.360001,5748600,24518285.73,5.671791377,-5368379.196,110.25,101.489998,80.66889913,87.35370399,10668452.39,-17.8395033,64.42740497,5.160004,9.35017417,-3.572866345,166351800
109.360001,117.769997,109.150002,117.18,10903600,86166305.96,6.364797225,12582855.26,117.769997,102.400002,96.57376768,90.18456742,11194265.04,-2.604843957,72.11290976,13.790001,16.82950797,66.09441406,177255400
118.25,121.889999,115.5,117.82,12064100,107114280.3,6.886271355,25447910.71,121.889999,105.720001,78.8351531,85.3592733,11253817.05,-15.20358464,72.52946933,13.14,15.28376072,70.72967083,189319500
118,119.25,114.269997,115.239998,4806700,21096741.8,7.010545555,1028224.722,121.889999,107.360001,57.80456754,77.73782944,10989639.47,-25.00940955,68.11248949,14.589996,11.46145576,-45.34922061,184512800
118.32,120.279999,115.699997,120.089996,6818700,30443258.99,7.414913551,-6081229.959,121.889999,107.360001,88.14227273,74.92733112,11191934.56,-6.769474505,71.61232004,20.539993,14.72105082,-20.517782,191331500
121.370003,122.18,118.82,121.610001,7814200,50127214.93,7.768479605,-2173727.261,122.18,115.239998,95.62548667,80.52410898,11278240.31,-2.120532231,72.62634205,20.120003,20.82463843,-22.68144264,199145700
124.639999,125.32,121.910004,123.449997,8603300,29007074.89,8.103740672,-7097636.419,125.32,115.239998,83.07690052,88.94821997,11396471.52,-6.229191162,73.84432164,21.049995,24.00802941,-26.58423361,207749000
123.190002,123.25,120.790001,122.269997,5600100,14588253.68,8.179928223,-13054529.97,125.32,115.239998,72.39817039,83.70018586,11314236.65,-10.15990441,71.64276764,16.549996,20.47492306,-21.34470069,202148900
124.879997,126.089996,122.349998,125.610001,7483600,29493289.63,8.412839835,-9562154.075,126.089996,120.089996,95.38022092,83.61843061,11467212.5,-1.558931826,74.00514514,16.360001,22.66601421,27.95322037,209632500
125.5,129.940002,124.510002,129.899994,11344000,84496593.07,8.841669288,10236882.98,129.940002,121.610001,99.64021589,89.13953573,11722801.95,-0.115496539,76.69111555,22.539993,22.87172983,71.81110472,220976500
133.029999,133.259995,126.82,127.260002,9922400,56181894.56,8.866289363,8396641.074,133.259995,122.269997,51.88455584,82.30166422,11492254.83,-18.34299745,71.77610531,10.080002,16.48512769,13.46499102,211054100
126.279999,126.32,107.300003,109.050003,32371900,22378819.99,7.331888768,-3875039.895,133.259995,109.050003,6.741142293,52.75530467,10072430.13,-79.11764418,48.62647156,-8.769997,1.574144918,463.1266743,178682200
106.519997,121.620003,104.5,120.25,26029000,435131230.2,6.939615826,122787315.7,133.259995,109.050003,54.76357002,37.79642272,13397191.01,-45.23642998,57.66943832,5.010002,2.619901007,138.7193221,204711200
120.970001,122.730003,116.18,119.029999,11398100,433919765.9,6.455873517,163055784.7,133.259995,109.050003,50.52156303,37.34209178,13133112.78,-49.47843697,56.50271515,-1.059997,1.026989475,-5.520511269,193313100
118.5,120.550003,116.510002,119.68,5890300,43449727.68,6.055153856,40465529.45,133.259995,109.050003,52.78165034,52.6889278,13195355.72,-47.21834966,57.00184148,-1.930001,3.852830681,22.54353299,199203400
119.889999,126.68,119.879997,122.43,9797800,36264576.56,5.891568323,-15649898.46,126.68,109.050003,80.83859333,61.38060223,13330702.69,-37.65645648,59.1381768,-1.019997,1.948541992,43.69014622,209001200
124,125.559998,121.82,122.739998,7736400,20144938.16,5.720991825,-42312467.7,126.68,119.029999,82.23623986,71.95216118,13355511.13,-36.57857729,59.38316015,0.470001,0.929197427,-0.995623352,216737600
124.470001,124.5,119.559998,121.699997,6869000,12090431.28,5.439189738,-51936092.05,126.68,119.029999,52.5714,71.88207773,13289959.04,-40.19471492,58.12413364,-3.910004,-1.417578001,-20.15854381,209868600
120.400002,124.75,120.190002,124.07,5284300,30521353.65,5.345479628,-45287181.99,126.68,119.68,74.33627814,69.71463933,13423726.92,-31.95409109,60.19525814,-5.829994,1.472154285,-5.639185015,215152900
128.139999,130.679993,126.610001,129.389999,9633100,43441827.37,5.635530264,-34339096.96,130.679993,121.699997,88.39932932,71.76900249,13650312.48,-13.45617758,64.4461178,2.129997,3.009312929,28.72280721,224786000
129.320007,135.369995,128.25,134.619995,9678900,84361760.77,6.215763004,-13718620,135.369995,121.699997,95.25616608,85.99725785,14039686.28,-2.429543639,68.05758888,25.569992,3.633565218,-14.67824401,234464900
134.800003,137.490005,128.179993,131.740005,13127000,99259846.57,6.369783606,704476.9616,137.490005,121.699997,67.93085468,83.86211669,13832620.93,-17.42952146,64.19085252,11.490005,3.520354337,32.29662179,221337900
132.570007,134.970001,131.449997,134.279999,6351700,55355093.69,6.620485496,-7428902.65,137.490005,124.07,81.44505524,81.54402534,14085714.15,-9.730237992,66.02427732,15.25,23.13617176,-80.37897065,227689600
135,136.520004,132.630005,135.550003,5323600,30947664.93,6.842768088,-17846839.58,137.490005,129.389999,82.16910582,77.18167191,14145787.76,-5.880575041,66.93583419,15.870003,12.72349522,-79.54742787,233013200
134.589996,138.25,133.610001,138,6269900,41404457.75,7.134382208,-17159121.56,138.25,131.740005,97.51738008,87.04384705,14242009.11,-0.740740741,68.68150023,15.57,15.93715967,-44.99170914,239283100
140.009995,144.889999,139.649994,144.679993,10200700,78087729.6,7.814428244,-3645912.092,144.889999,131.740005,98.74323205,92.80990598,14545508.3,-0.519945544,72.88497749,21.939995,20.88903158,73.17793661,249483800
144.75,145.729996,141.100006,142.149994,9254500,53462040.02,8.056351249,-5621781.076,145.729996,134.279999,74.92995623,90.39685612,14367130.07,-12.11506763,69.10205255,20.449997,16.10715838,-5.545122374,240229300
141.889999,141.949997,132.360001,134.229996,18212200,21957146.16,7.522287081,-15943304.52,145.729996,134.229996,13.98650486,62.55323104,13851508.37,-39.35661315,58.8114462,10.159996,9.361249949,135.4092343,222017100
154.350006,158.880005,150.460007,153.479996,27246800,84206607.21,8.553749206,1090292.089,158.880005,134.229996,79.63797818,56.18481309,16463330.32,-13.73348942,70.36365452,24.089997,26.11339341,296.6632698,249263900
152.399994,155.949997,151.25,153,8927700,74830728.98,9.2261059,4976230.165,158.880005,134.229996,77.82803879,57.15084061,16378118.2,-14.95423182,69.83767383,18.380005,23.31748207,68.94763734,240336200
149.429993,150.5,142.050003,147.380005,14912200,83995940.36,9.199421589,9029751.166,158.880005,134.229996,56.63650729,71.36750809,16050185.99,-29.24719723,63.82211978,15.64,13.90370673,54.8016734,225424000
149.5,149.839996,144.449997,145.429993,8748900,75391709.51,8.918121852,7129413.474,158.880005,134.229996,49.28352198,61.24935602,15852879.92,-34.7635331,61.83197343,11.149994,8.030009212,-9.608529895,216675100
142.720001,144.839996,138.050003,139.360001,11693800,7296837.353,8.111883416,-15962676.13,158.880005,139.360001,6.288996036,37.40300844,15487716.23,-60.48962374,55.98024575,3.809998,5.784116981,-10.91795536,204981300
136.429993,143.600006,135,139.669998,10179200,48766327.2,7.412501115,-10763450.01,155.949997,139.360001,22.2911631,25.95456037,15513728.31,-62.57328824,56.20818442,1.669998,4.013999881,60.2594581,215160500
141.630005,143.910004,140.970001,142,7108100,45588663.4,6.965948178,-8669073.255,150.5,139.360001,45.16129032,24.58048315,15683539.69,-54.98370815,57.96981632,-2.679993,4.758389419,33.52055,222268600
143.429993,147.380005,142.830002,144.899994,8037700,14960453.68,6.768039293,-16769524.65,149.839996,139.360001,66.71156785,44.72134042,15828704.82,-50.96612075,60.12012822,2.75,4.999995652,28.19502703,230306300
148.649994,149.779999,147,149.580002,6418200,28354204.61,6.909187793,-14297195.41,149.779999,139.360001,98.64684023,70.1732328,16088308,-35.06787933,63.37650147,15.350006,3.386791013,-37.08078857,236724500
150,150.309998,146.25,147.860001,6266300,22404598.69,6.803828984,-13879099.39,150.309998,139.669998,83.99740483,83.1186043,16014505.96,-41.55355331,61.3924091,-5.619995,4.016888668,-32.28915663,230458200
149.220001,157.479996,148.139999,157.100006,10592400,100784399.3,7.380840813,12492703.66,157.479996,142,97.6984245,93.44755652,16406096.94,-6.711910752,67.31267483,4.100006,17.03792795,-41.83898705,241050600
157,162.300003,155,161.839996,12931900,182116280.5,8.126922322,48023794.06,162.300003,144.899994,97.63735503,93.11106145,16725688.72,-1.536429423,69.86550714,14.459991,5.446963916,-52.53791271,253982500
165.149994,173,160.25,164.220001,24171100,166953655.4,8.808702566,53368969.06,173,147.860001,67.17757383,87.50445112,16915864.12,-21.60432878,71.08654201,18.790008,7.333333987,170.7427445,278153600
162.300003,168.800003,160.949997,167.009995,17566900,181764073.3,9.465040425,55416312.8,173,147.860001,77.60745794,80.80746227,17326515.83,-15.76317105,72.49358773,27.649994,13.31930339,17.80220222,295720500
169.059998,171.5,163.25,166.449997,14740100,140595205.8,9.826729331,38116830.76,173,157.100006,73.65244273,72.8124915,17267612.6,-17.23685,71.73896278,26.779999,14.45369251,68.47946599,280980400
164.220001,167.75,162.509995,166.059998,9436000,68600080.07,9.967007278,4667063.489,173,161.839996,61.44443333,70.90144467,17233075.95,-18.26316316,71.18322373,24.059998,19.15901034,-19.30766731,271544400
166.369995,169.210007,163.960007,169,11028400,85596445.63,10.1978576,-4033276.216,173,164.220001,68.62745098,67.90810902,17400135.2,-10.52631579,72.88829106,24.100006,20.99950055,8.342502358,282572800
173.399994,173.699997,166.399994,168.940002,12061100,77912712,10.25772217,-9670668.959,173.699997,166.059998,62.66670588,64.24619673,17396219.93,-12.29972964,72.79363175,19.36,18.97183239,69.68106808,270511700
169.770004,171.619995,165.559998,170.619995,11475700,78944130.67,10.32174403,-10769544.69,173.699997,166.059998,72.47541153,67.92318947,17516159.33,-7.958662116,73.81892579,22.759994,17.75017396,42.77343021,281987400
170.100006,171.5,168.25,169.929993,6685300,64175055.42,10.19923399,-14939286.46,173.699997,166.059998,66.30917492,67.15043078,17469750.61,-11.5184982,72.60862413,12.829987,13.6047538,4.161602942,275302100
168.570007,169.699997,165.149994,166.970001,8619700,18517833.98,9.750895044,-29814270.69,173.699997,166.970001,30.90346089,56.56268245,17353300.1,-21.80109197,67.49616469,5.130005,12.92438785,37.55645277,266682400
163.119995,164.5,158.509995,160.699997,14344500,32830572.73,8.788339765,-28635050.03,173.699997,160.699997,14.41739112,37.21000898,17029615.89,-47.35883942,58.15519156,-3.520004,2.291528238,35.42256712,252337900
161.449997,167.5,160.630005,166.369995,8967800,72314489.14,8.386356526,-12986390.9,171.619995,160.699997,59.95423341,35.09169514,17535734.66,-26.70310674,63.12505222,-0.64,2.799060252,-30.65365492,261305700
166.410004,167.899994,162.130005,163.520004,5832500,53679748.9,7.748491669,-11333321.25,171.5,160.699997,38.56818377,37.64660277,17382112.32,-39.82783175,59.31185389,-2.929993,-0.42625563,-75.86994386,255473200
164,166.759995,160.509995,164.929993,6160000,29103264.87,7.272915856,-17446553.92,169.699997,160.699997,57.37262603,51.9650144,17432404.39,-46.89842464,60.58054297,-1.130005,-1.24543564,-64.93405211,261633200
162.770004,166.369995,162.160004,165.539993,5401200,42614684.8,6.86609246,-14062283.32,167.899994,160.699997,74.86686633,56.93589204,17455187.39,-53.7195716,61.14500271,-3.460007,-0.546713137,-63.3571007,267034400
168,170.850006,165.850006,166.580002,7574900,16251823.13,6.552073794,-19787602.85,170.850006,163.520004,58.70406714,63.64785317,17489120.56,-46.87290364,62.14038627,-2.36,0.313142242,-19.72339975,274609300
165.080002,168.419998,163.360001,166.229996,5496900,12457654.89,6.20345956,-21538141.38,170.850006,163.520004,55.31909976,62.96334441,17473204.73,-49.1770903,61.56874059,-4.389999,-1.639055621,-50.15686772,269112400
167.070007,167.449997,164.199997,166.220001,5439700,22326484.07,5.858836732,-17156175.92,170.850006,164.929993,55.22243642,56.41520111,17472874.21,-49.24289016,61.55132724,-3.709992,-1.61003964,-54.89880691,263672700
170.800003,180.470001,169.080002,177.919998,15594600,143294374.1,6.455398815,24685881.86,180.470001,165.539993,86.07316539,65.53823385,17855767.2,-11.61203235,71.65683431,10.949997,4.27851554,35.89236386,279267300
178.899994,185.830002,178.559998,183.389999,13401700,194597133.1,7.285578318,55882521.38,185.830002,166.220001,89.14106412,76.81222198,18335210.09,-8.931194637,74.96919697,22.690002,7.920912467,100.4651998,292669000
184.479996,185.479996,177.110001,181.110001,8173400,88658512,7.671097139,29856810.71,185.830002,166.220001,78.99421099,84.73614683,18168593.32,-17.27671959,71.23240537,14.740006,8.468587121,-5.177674397,284495600
179.139999,184.960007,177.649994,182.330002,6273400,55528758.75,7.983043906,5954388.425,185.830002,166.220001,83.81877397,83.98468303,18223651.33,-12.8111241,72.03562002,18.809998,13.45986646,-56.26616473,290769000
183.559998,186.300003,180.5,185.240005,8252700,64712101.84,8.368608776,-1443210.474,186.300003,177.919998,93.84437899,85.55245465,18323775.35,-3.814313404,73.9070323,20.310012,11.34219545,-7.97408506,299021700
186.699997,189.679993,185.610001,188.639999,6614400,55961049.93,8.846545346,-7122725.589,189.679993,181.110001,91.726375,89.79650932,18475249.82,-3.336522511,75.93352982,23.100006,15.36203179,13.40591513,305636100
187.520004,191.279999,186.429993,190.899994,5916400,44334214.51,9.300466245,-12498090.72,191.279999,181.110001,97.31824239,94.29633213,18554493.41,-1.234985215,77.20104053,24.319992,15.74607537,-3.954545455,311552500
189,194.5,188,193.369995,8924700,72356818.14,9.747151174,-4644630.683,194.5,182.330002,93.29374126,94.11278622,18631044.03,-3.324521429,78.53182782,27.139999,16.81164865,65.23550322,320477200
193.960007,194.229996,188.369995,193,7755900,80655979.21,9.956524082,1631029.733,194.5,185.240005,89.28571429,93.29923264,18613967.47,-4.413062016,77.79925222,26.779999,15.86024594,2.389470488,312721300
188.589996,191.830002,175.399994,180.949997,20775400,135827911,9.045844223,21604775.5,194.5,180.949997,29.0575982,70.54568458,18129725.93,-41.89859207,58.62010412,3.029999,8.85520144,277.9475704,291945900
175.050003,179.690002,168,173.309998,23816500,215013329.3,7.619803453,53007143.18,194.5,173.309998,20.0377283,46.1270136,17252555.23,-68.0475359,50.17454905,-10.080001,4.265429526,337.8274537,268129400
176.399994,181.179993,172.649994,180.979996,14414000,233198028.5,7.027551369,66820775.77,194.5,173.309998,48.98111698,32.69214783,18306576.98,-43.41684147,56.88961318,-0.130005,1.719872996,-7.5705693,282543400
182.460007,186.729996,180.259995,183.070007,11485600,145508124.4,6.650174673,38495858.19,194.229996,173.309998,57.4533332,42.15739283,18473034.15,-37.72274544,58.52972641,0.740005,-0.174487159,-14.29743988,294029000
184.399994,185.929993,173.210007,174.729996,13757200,34574955.4,5.61342368,-11888148.97,191.830002,173.309998,28.24169297,44.89204772,17949791.53,-74.60378868,50.30525489,-10.510009,-3.52272374,68.31673477,280271800
174.729996,174.990005,161.5,168.779999,15316500,113250812.4,4.262540109,-6385820.231,186.729996,168.779999,28.85453886,38.18318834,17481324.18,-77.93939697,45.40345869,-19.86,-7.431581666,144.1499028,264955300
173.089996,175.75,169.690002,172.929993,8883900,129102940,3.486633241,1489520.336,186.729996,168.779999,45.3031899,34.13314058,17857929.13,-65.36365758,49.12690793,-17.970001,-6.645439251,7.648405976,273839200
172.75,179.289993,171.199997,178.699997,8311100,86376781.43,3.299280507,-9018847.19,186.729996,168.779999,68.17280906,47.44351261,18154350.46,-47.87879697,53.84052695,-14.669998,-5.269297102,25.65160861,282150300
175,182.5,174.149994,179.720001,7769600,102417093.2,3.196263379,-7394094.04,185.929993,168.779999,74.58045936,62.68548611,18201789.49,-44.78787576,54.64062615,-13.279999,-5.856465873,31.32310189,289919900
185.279999,188.789993,183.179993,183.940002,10978500,39542523.99,3.415765557,-26062776.69,188.789993,168.779999,82.22795074,74.99373972,18384227.28,-31.99999394,57.89252867,2.990005,-4.876657829,23.01253824,300898400
184.899994,187.300003,182.089996,183.559998,8205400,5024265.539,3.518500385,-42313703.95,188.789993,172.929993,72.61781432,76.47540814,18361546.66,-33.15152121,57.49281926,10.25,-4.891192746,5.795587875,292693000
183.539993,184.800003,180.990005,182.800003,6705000,14788055.4,3.498267382,-42008449.78,188.789993,178.699997,65.94660965,73.59745824,18327573.77,-35.45453636,56.65039275,1.820007,1.022385206,-67.72625316,285988000
184.149994,185.960007,182.520004,183.399994,5930800,9421757.227,3.49041155,-39772081.61,188.789993,179.720001,63.18306443,67.2491628,18349581.1,-33.08891941,57.18378339,0.329987,5.821935328,-75.0979363,291918800
183.279999,183.389999,171,172.600006,11532100,9213956.303,2.582942421,-35307678.41,188.789993,172.600006,8.993854017,46.04117603,18000330.44,-63.40255434,46.17108944,-2.12999,-4.630340471,-19.99375607,280386700
170.5,177.779999,166.110001,171.539993,11386700,64149713.54,1.757967652,-12791983.58,187.300003,171.539993,25.62525478,32.60072441,17929506.71,-63.20998323,45.24997908,2.759994,-6.298144731,-0.86107822,269000000
168.910004,171.809998,160.149994,164.5,13320400,105334035.8,0.529991196,10685992.62,185.960007,164.5,16.85394734,17.15768538,17462197.09,-84.81143103,39.59959453,-8.429993,-5.854745169,-3.175064693,255679600
165,174.5,162.830002,173.149994,10825700,160061672.3,0.251889605,36732504.27,185.960007,164.5,50.36804902,30.94908371,18162631.02,-54.60893696,48.16437481,-5.550003,2.589166386,-29.32001436,266505300
174.210007,174.5,166.800003,169.660004,7595500,127417626.7,-0.247270554,33661835.03,183.389999,164.5,40.92086039,36.04761892,17944429.54,-66.79465666,45.36906917,-10.059997,-1.890932246,-14.50263961,258909800
170.179993,170.5,162.199997,162.860001,7841700,14906239.18,-1.177982934,-6453592.5,177.779999,162.860001,15.37156115,35.55349019,17640000.55,-90.53768473,40.44385093,-21.080001,-8.864015818,-5.647868513,251068100
162.759995,165.449997,153,164.470001,14111700,158707830.7,-1.76531619,23477292.85,174.5,162.860001,53.34884186,36.5470878,17717521.96,-67.95193282,42.04796682,-19.089997,-8.48542172,81.62711079,265179800
164.630005,167.679993,158.169998,159.220001,8401800,162098178.8,-2.624163429,34666193.72,174.5,159.220001,28.93023721,32.55021341,17267066.41,-82.62083762,38.41449059,-23.580002,-13.43916534,-23.47041946,256778000
155.669998,162.440002,153.300003,159.940002,9333800,60771175.51,-3.209708468,3851589.062,174.5,159.220001,32.27907907,38.18605271,17305059.78,-80.60909931,39.19057102,-23.459992,-12.86772513,13.75191947,266111800
163,165.899994,160.410004,162.169998,7180600,67182600.31,-3.453999534,-7064531.231,170.5,159.220001,52.39998857,37.86976828,17435198.19,-74.37831854,41.6434356,-10.430008,-11.28556054,7.093214019,273292400
165,175.389999,164.220001,175.199997,13120400,151597947.8,-2.56660373,15971442.05,175.389999,159.220001,99.15139791,61.27682185,18012143.44,-35.27698234,53.45702277,3.660004,-4.471099928,121.2247926,286412800
180,181.429993,171.360001,176.809998,22467100,255976745,-1.713668433,57154735.51,181.429993,159.220001,83.57626505,78.37588384,18132713.4,-27.76094374,54.67789056,12.309998,2.439160981,94.82227868,308879900
154.809998,160.729996,146.350006,151.160004,31071700,240914347.6,-3.072038667,64013980.43,181.429993,151.160004,13.71151591,65.47972629,14873389.91,-87.85660722,37.70760285,-21.98999,-11.88060501,172.8771286,277808200
144.190002,145.649994,137.619995,139.770004,22284700,160370633.2,-5.00988385,35373036.92,181.429993,139.770004,4.90757612,34.06511903,12532118.06,-95.3025807,32.83427113,-29.89,-15.03343222,67.2975286,255523500
136.479996,140.600006,132.320007,137.949997,22477900,150950582.5,-6.616231674,17443267.81,181.429993,137.949997,11.46404318,10.02771174,12241939.13,-88.53595682,32.11993,-24.910004,-20.32919331,107.6346102,233045600
141,145.419998,137.100006,144.699997,13997600,224526613.4,-7.260906103,31933165.94,181.429993,137.949997,25.20870195,13.86010708,13341800.15,-74.79129805,37.54678796,-19.770004,-14.71178027,84.2880653,247043200
144.690002,144.699997,136.179993,137.800003,14985200,117310589.1,-8.23367441,843646.8845,160.729996,137.800003,19.28897614,18.65390709,12674327.05,-88.84138147,34.50957395,-21.419998,-15.38744802,91.0963184,232058000
140.839996,142.369995,136.339996,138.699997,12658300,34309752.8,-8.830189381,-38360844.9,145.649994,137.800003,47.86193715,30.78653841,12772197.8,-87.00877251,35.24535587,-21.240005,-15.66851331,-10.29925523,244716300
138.919998,140.399994,134.110001,137.600006,12203700,59327965.7,-9.284664046,-42951356.08,145.419998,137.600006,40.30536357,35.81875895,12671808.35,-89.24862451,34.73174745,-24.569992,-13.57869292,45.25101764,232512600
136.850006,137.949997,134.350006,135.449997,9900200,41173476.41,-9.706436493,-46701052.15,145.419998,135.449997,11.84788997,33.3383969,12481124.75,-93.62657118,33.69810223,-39.75,-15.31199493,6.068268015,222612400
135.270004,135.449997,119.610001,121.580002,23138200,29336721.7,-11.03270868,-47755708.67,144.699997,121.580002,7.851738996,20.00166418,11467350.46,-96.81332699,27.92445457,-55.229996,-25.02928809,222.2321254,199474200
119.43,129,119.220001,126.089996,19816200,155562701.8,-11.58631034,-3682919.146,142.369995,121.580002,29.67601201,16.45854699,12325658.91,-88.95676598,32.00400681,-25.070008,-28.03082297,51.03350508,219290400
126.080002,127.449997,119.059998,121.110001,13849600,148167072.3,-12.28527067,12328514.37,140.399994,121.110001,9.606388867,15.71137996,11543007,-96.71315831,29.98574706,-18.660003,-31.50274172,-38.35608512,205440800
122.889999,124.790001,120.25,122.099998,11903800,32894984.65,-12.61391196,-18919610.2,137.949997,121.110001,16.09317184,18.45852424,11656218.64,-95.1258614,30.91840992,-15.849999,-19.22466607,-61.68925421,217344600
121.580002,122.75,117.93,121.379997,11096700,50098400.8,-12.78508215,-24509155.09,135.449997,121.110001,19.69176707,15.13044259,11586024.15,-94.56693326,30.59915939,-23.32,-13.15733453,-50.20484907,206247900
124.5,125.839996,120.300003,120.839996,10267300,31407275.69,-12.8165679,-30514858.26,129,120.839996,26.28722674,20.69072188,11536656.63,-93.20094329,30.34607628,-16.960007,-12.40304558,-54.32269029,195980600
119.379997,122.720001,116.099998,120.5,13885500,52717503.19,-12.72230066,-23417131.87,127.449997,120.5,38.76654086,28.24851156,11507768.5,-85.1099743,30.17684082,-18.199997,-16.72425536,-0.800851575,182095100
121.309998,126.949997,119.519997,126.940002,12367600,148190777.7,-11.98972873,11993173.71,126.949997,120.5,99.90788018,54.98721593,12249865.17,-63.02863574,37.30855582,-10.660004,-7.880987492,-17.46790166,194462700
129.770004,130.589996,126.980003,127.279999,9716200,85757069.05,-11.252019,5523648.357,130.589996,120.5,77.15667732,71.94369945,12282990.63,-61.86902797,37.67051682,-8.169998,-8.233596429,-23.24245752,204178900
126.349998,128.550003,123.93,124.169998,7751200,-11482219,-10.79390441,-28564898.97,130.589996,120.5,55.69358947,77.58604899,12045581.83,-71.7832158,35.64329411,2.589996,-9.760179807,-36.48483657,196427700
132.679993,144.940002,131.589996,144.699997,25682400,330746302.8,-8.674254543,68977488.52,144.940002,120.5,99.16780525,77.33935734,13327148.48,-0.832194753,53.45145523,18.610001,6.829088376,159.4129412,222110100
144.320007,144.429993,137.130005,138.949997,13147700,350293493.7,-7.373397759,108830072.5,144.940002,124.169998,76.43586223,77.09908565,12306596.98,-20.76977867,49.33394475,17.839996,14.28688494,-43.17751597,208962400
140.149994,143.350006,139.5,140.479996,9288400,16237421.04,-6.148129444,8949190.719,144.940002,124.169998,78.77198679,84.79188475,12451368.25,-15.46465111,50.42819807,18.379998,11.41248351,-53.12723933,218250800
141.509995,142.490005,136.300003,137.360001,7909600,4007529.781,-5.366985727,-36616061.82,144.940002,124.169998,63.92194061,73.04326321,12245077.23,-26.28294018,48.14471983,15.980004,13.41755418,-42.88932532,210341200
137,141.699997,134.210007,141.600006,9061500,68672533.63,-4.355582295,-31352431.02,144.940002,137.360001,74.98131462,72.558414,12489229.41,-11.58112183,51.36761479,20.76001,15.97052278,-23.87724928,219402700
140.050003,145.869995,139.860001,142.190002,10748200,85305567.49,-3.466470724,-21056577.55,145.869995,137.360001,68.43913561,69.11413028,12526985.4,-12.36141542,51.81638081,21.690002,17.1445094,-3.140573324,230150900
141.880005,143.050003,139.490005,139.649994,7137800,12787009.74,-2.932991121,-38004489.73,145.869995,137.360001,46.65516808,63.35853944,12334985.16,-20.89352243,49.69050211,12.709992,15.5660366,-30.48026258,223013100
139.699997,148.240005,138.529999,147.470001,10767800,89735214.02,-1.857780149,-16999253.37,148.240005,137.360001,94.51173122,69.86867831,12734681.89,-2.395780437,55.71455967,20.190002,22.38174357,-22.45291851,233780900
148.050003,151.800003,147.320007,147.649994,10591900,89093732.6,-0.97984869,-7064923.19,151.800003,139.649994,76.40699293,72.52463074,12747824.42,-11.62467344,55.84561243,23.479996,16.31478783,-14.35767651,244372800
148.479996,150.429993,146.100006,147.940002,6675300,2127310.925,-0.257709744,-30029747.45,151.800003,139.649994,70.91183243,80.61018553,12768628.59,-10.81232622,56.0711785,3.240005,16.23193209,-31.29721496,251048100
147.580002,154.630005,146.320007,152.460007,10495000,70142575,0.671575695,-15053250.85,154.630005,139.649994,86.52175658,77.94686065,12972578.77,-6.18056823,59.54042277,13.51001,22.7832886,35.39838993,261543100
152.240005,154.899994,145.949997,147.979996,11581900,76255031.36,1.034615253,-5613152.419,154.899994,147.470001,57.7275497,71.72037957,12664185,-22.34420194,54.91156342,7.5,2.266758167,-54.90335794,249961200
146.899994,147,139.100006,140.720001,12740000,25067537.64,0.728112568,-17527937.2,154.899994,140.720001,10.2531407,51.50081566,12095969.45,-45.78623102,48.35142141,3.36,1.273842417,-3.100922595,237221200
141.580002,144.350006,141.580002,143.240005,7412600,19845784.34,0.680703517,-22470185.47,154.899994,140.720001,26.20254522,31.39441187,12324116.48,-50.02140712,50.55934111,1.639999,1.964698945,-20.19508204,244633800
144.850006,146.240005,142.600006,143.550003,5385500,10470808.9,0.660531555,-25432216.9,154.899994,140.720001,28.16455937,21.54008176,12340158.73,-54.85741001,50.83776013,1.360001,4.506407946,-31.91185395,250019300
150,154.970001,149.820007,151.410004,9941500,10071031.55,1.264208512,-24459139.2,154.970001,140.720001,77.56774971,43.97828476,12635038.8,-17.14835274,57.38980119,11.76001,6.927964396,9.711416432,259960800
155.039993,158,154.289993,155.5,7129500,12757279.12,2.049035341,-20982788.71,158,140.720001,86.77248257,64.16826388,12903585.75,-10.50862016,60.35096565,8.029999,9.360712999,-33.66796301,267090300
155.300003,155.5,150.800003,151.119995,5460200,481278.2477,2.291175218,-21559119.36,158,143.240005,58.09984264,74.14669164,12702767.45,-28.91974369,55.87293693,3.470001,8.213391688,-23.50304015,261630100
151.119995,154.809998,150.75,152.440002,4467500,1600980.996,2.560075393,-19478701.99,158,143.550003,63.89610282,69.58947601,12750461.35,-28.55674224,56.91060711,4.5,3.37017764,-58.51055926,266097600
152.320007,153.199997,148.660004,150.429993,4262400,9885977.472,2.581234921,-14220695.83,158,150.429993,18.95063981,46.98219509,12691554.8,-38.88036267,54.7975,-2.030014,1.882830419,-59.75792823,261835200
149.800003,152.479996,146.550003,150.100006,6188400,24428903.5,2.542073367,-6149608.128,158,150.100006,31.00440114,37.95038125,12682204.69,-40.57521106,54.44011948,2.12001,1.460054056,-7.2940542,255646800
150,152.190002,148.600006,149.559998,4695000,20552778.31,2.43934418,-3522056.802,155.5,149.559998,33.63124032,27.86209376,12659940.97,-44.65610941,53.82151355,8.839997,-1.902144082,-55.26441162,250951800
150,150.399994,145.240005,147,5361100,6970640.988,2.126843191,-6448551.607,154.809998,147,18.3907658,27.67546909,12579577.29,-58.20107668,50.87041053,3.759995,-0.66224897,-53.7113945,245590700
147.619995,150.399994,145.25,149.360001,5034100,25576566.89,2.046030892,-1139454.732,153.199997,147,51.75879574,34.59360062,12665646.69,-45.71429494,53.40675738,5.809998,6.139852145,-60.48587127,250624800
148.850006,153.699997,148.759995,151.279999,6163200,32185639.68,2.112562055,3238922.127,153.699997,147,71.39479565,47.1814524,12730359.21,-35.55557213,55.42303033,-0.130005,5.61295289,-16.85508459,256788000
152.5,153.429993,146.850006,147.529999,5382000,11345985.17,1.84146753,-1895170.333,153.699997,147,27.06851259,50.07403466,12577582.9,-55.39684827,50.79923371,-7.970001,2.772550273,-0.064989323,251406000
148.460007,148.899994,142.25,145.720001,7446100,21111199.87,1.463698845,-716078.9029,153.699997,145.720001,30.30569353,42.92300059,12511552.88,-74.78684833,48.68788077,-5.399994,-3.75800994,-25.10083991,243959900
145.779999,147,137.820007,139.339996,6316100,26607386.45,0.642099632,1580161.401,153.699997,139.339996,9.571725171,22.31531043,12185543.03,-92.46784179,42.05306408,-13.100006,-10.39228553,-11.40893471,237643800
140.5,162,136.669998,161.270004,27607000,682666846.7,1.740481517,211122073.3,162,139.339996,97.11805787,45.66515886,13179601.65,-2.881942133,61.48275011,10.840011,6.716522853,405.6041903,265250800
168.449997,172.229996,162.100006,164.130005,20465600,703517498.6,2.809350806,284285147.1,172.229996,139.339996,77.22162133,61.30380146,13669190.82,-22.77837867,63.21502896,14.029999,7.668592788,358.0996083,285716400
162.5,172.699997,162.399994,170.970001,11959400,125664182.9,4.160409323,104508972.6,172.699997,139.339996,95.19845671,89.8460453,14522079.49,-4.801543292,67.03365931,21.410003,13.65419727,180.5790165,297675800
170.190002,173.199997,167.949997,170.009995,9206200,113854319.8,5.094937205,17705674.49,173.199997,139.339996,91.2674457,87.89584124,14454926.8,-8.732554304,65.99810836,23.009995,13.26448248,48.7654321,288469600
171.240005,177.289993,170.809998,176.679993,9734700,69597143.43,6.30113482,-33496201.25,177.289993,161.270004,98.49827653,94.98805964,14816113.42,-1.501723474,69.52111935,27.319992,18.13318759,107.341853,298204300
177.809998,180.320007,174.759995,178.559998,7022600,80689169.03,7.324325546,-47868033.07,180.320007,164.130005,90.34023653,93.36865292,14919697.78,-4.032093098,70.45046974,27.279999,21.46938639,30.99177408,305226900
177.229996,182.380005,173.419998,181.5,7867400,87258826.08,8.277032678,-47305434.01,182.380005,170.009995,95.595573,94.81136202,15035325.35,-1.925191129,71.89376899,33.970001,21.51847803,56.2821557,313094300
177.850006,180.479996,173.529999,174.600006,7664300,64512447.12,8.378703615,-50012270.07,182.380005,170.009995,46.08458291,77.34013081,14736234.37,-17.02034086,63.99373378,28.880005,15.415129,24.3558541,305430000
175.160004,177.919998,164.710007,169.619995,8716400,39037330.22,7.965610695,-54678761.1,182.380005,169.619995,27.78714519,56.48910036,14517630.15,-27.91513464,58.95817063,30.279999,14.97322317,61.95466369,296713600
171.5,178.979996,171,178.380005,6093400,81831974.71,8.249990422,-38000505.9,182.380005,169.619995,77.36275918,50.41149576,14967787.87,-8.750819049,64.28234764,17.110001,22.41284915,-18.16655699,302807000
175.300003,179.089996,173.130005,175.229996,5935500,53131536.96,8.127495297,-36854949.34,182.380005,169.619995,59.5358811,54.89526183,14860184.64,-15.64210874,61.20750882,11.099991,25.75714155,-6.025870395,296871500
178,184.779999,177.009995,182.839996,8565000,56415820.38,8.545967832,-31990863.36,184.779999,169.619995,90.33381279,75.74415102,15117955.32,-4.032431843,65.50086024,11.869995,13.37507997,-68.9752599,305436500
178.850006,186,178.509995,181.410004,6508800,62682343,8.662367546,-25098856.13,186,169.619995,78.44059413,76.10342934,15050968.44,-9.304674263,64.06599867,11.400009,10.52823888,-68.19638809,298927700
182.889999,184.880005,175.160004,177.110001,6764900,22670669.19,8.311827281,-32728671.56,186,175.229996,40.73334,69.83591564,14896688.86,-18.02148518,59.82228722,0.430008,3.591273302,-43.43445323,292162800
180.699997,181.600006,176.199997,178.729996,4686300,17149436.46,8.071696165,-34631381.78,186,175.229996,43.51199049,54.22864154,14958566.24,-30.41843441,60.87380227,0.169998,5.129110791,-49.09626122,296849100
178.300003,180.589996,169.360001,174.419998,7268000,42148512.6,7.447756604,-24307204.3,186,174.419998,30.40863764,38.21798938,14845558.11,-49.06779261,56.62754692,-7.080002,-1.279145964,-25.33925031,289581100
176.300003,180.110001,176,178.380005,5841600,44227034.98,7.189938344,-17212583.27,186,174.419998,54.20675807,42.70912873,15010569.75,-35.79143967,59.42786345,3.779999,-0.100802532,-16.81713326,295422700
181.009995,186.630005,179.600006,186.529999,8928500,73191599.67,7.556149332,-3529460.154,186.630005,174.419998,99.4209266,61.34544077,15277466.29,-0.456231793,64.50691793,16.910004,2.771349311,13.48730203,304351200
189.339996,199.300003,189.320007,196.559998,12970700,152094078.5,8.55707069,27494375.32,199.300003,174.419998,90.8483473,81.49201066,15757565.18,-7.921379927,69.55772102,18.179993,12.57731457,69.23528568,317321900
198.970001,202.199997,192.699997,196.619995,10709900,126038776.6,9.248537945,29396132.38,202.199997,174.419998,83.00851803,91.09259731,15761524.29,-14.88397836,69.58560208,21.389999,15.91793468,22.87068056,328031800
195.779999,198.270004,194.320007,195.320007,5173700,37001925.74,9.581186604,-828158.8712,202.199997,178.380005,73.74049318,82.53245284,15690713.89,-18.35153864,68.12959852,12.480011,9.496581189,-15.09337972,322858100
193.339996,202.720001,193.25,199.630005,8029300,49916867.41,10.07643897,-9008054.861,202.720001,186.529999,86.63496251,81.12799124,15804878.52,-8.129430381,70.34505195,18.220001,13.92456175,35.2758824,330887400
198.100006,201.880005,197,198.229996,6158000,51575496.53,10.23794435,-11007716.24,202.720001,195.320007,66.492485,75.62264689,15748568.89,-13.4592476,68.67506675,21.119995,8.417195546,-28.10274372,324729400
205.240005,206,201.360001,203.699997,9332800,20180962.81,10.68416154,-20814227.88,206,195.320007,82.70674826,78.61139859,15918494.06,-6.277300936,71.51992992,24.970001,12.28708038,43.38741396,334062200
203.699997,203.699997,193.410004,193.639999,16169000,5123722.988,10.10949811,-27724720.04,206,193.639999,3.058815686,50.75268298,15457581.19,-33.7336281,60.61662511,19.220001,9.333181586,139.0131414,317893200
215.009995,215.210007,206.270004,209.970001,18002300,43967951.55,10.8467335,-15671783.2,215.210007,193.639999,76.1384138,53.96799258,16821141.43,-11.42858302,68.90387407,31.589996,17.47888194,284.1474084,335895500
211.639999,213.979996,209.190002,209.600006,7818800,52112960.53,11.2712148,-6724734.983,215.210007,193.639999,74.266054,51.15442783,16789418.99,-12.23555129,68.55189953,23.070007,20.16971013,7.578425977,328076700
208.759995,218.360001,208.320007,217.649994,8278400,72708130.31,12.11750301,4099769.216,218.360001,193.639999,97.15428022,82.51958267,17089711.18,-1.448993878,71.91352212,21.089996,22.01479308,41.71459874,336355100
230,259.200012,228.449997,248,32681700,703675681.1,15.06354123,208917671.7,259.200012,193.639999,82.97612002,84.79881808,18244085.16,-12.46661913,80.41407062,51.380005,32.95448525,266.0379683,369036800
258.579987,265,247.5,253,24604600,745477321.8,17.59888694,287014820.1,265,209.600006,79.56751095,86.5659704,18902990.4,-13.48314607,81.41217105,57.679993,28.71388002,89.69369425,393641400
261.25,261.899994,248.330002,252.539993,17945800,181626984.3,19.34801608,113464471.6,265,209.600006,78.01692213,80.18685103,18858254.09,-14.59017316,81.0031824,52.909988,28.44064664,67.56272234,375695600
249.649994,252.679993,242.550003,244.809998,14589800,84811461.11,19.88128841,1346710.548,265,217.649994,64.37896173,73.98779827,18308951.21,-26.6781235,74.25271681,46.580002,25.33790151,181.9993428,361105800
237.259995,251.649994,234.990005,250.559998,13089300,224581980.3,20.53121644,-169636.5339,265,244.809998,60.49247383,67.62945256,18651630.64,-19.97233942,75.86399438,46.860001,25.51219342,63.01919221,374195100
258.480011,260,252.830002,254.839996,8745600,214228621.5,21.14786968,-4068789.375,265,244.809998,66.14459949,63.67201168,18875218.52,-14.16028432,77.01693591,61.199997,28.55773654,42.02013641,382940700
256.720001,256.98999,251.800003,252.660004,5935700,11437268.76,21.21609869,-69818528.73,261.899994,244.809998,65.66334531,64.10013954,18800405.54,-17.1986007,75.05044839,42.690003,24.03534989,-36.39957998,377005000
254.139999,257.5,249.449997,252.940002,7361100,21673089.7,21.0501116,-87112158.28,260,244.809998,71.77129384,67.85974621,18806983.49,-16.84592635,75.13825381,43.339996,30.62383976,-54.47399344,384366100
252.940002,254.850006,244.410004,246.210007,7812300,29117326.93,20.14331172,-83898916.86,260,246.210007,44.86207214,60.76557043,18611126.11,-26.24667419,68.86488427,28.560013,17.25961129,-56.60387839,376553800
242.699997,243,236.059998,238.839996,7728100,24448507.36,18.61538145,-76442768.25,260,238.839996,11.61235492,42.74857363,18377273.97,-36.54142403,62.69197619,-9.160004,13.95037651,-1.160024556,368825700
236.5,244.600006,232.429993,234.410004,8810100,26919055.56,16.85275432,-65657099.55,257.5,234.410004,7.897927591,21.45745155,18233933.57,-52.08581318,59.25380332,-18.589996,7.700441287,6.422738693,360015600
231.5,247.5,231.110001,241.490005,9754400,107741264,15.84451087,-29559796.08,257.5,234.410004,39.33309736,19.61445996,18500029.36,-41.47847195,62.76815609,-11.049988,-2.624997984,-70.1533274,369770000
243.789993,244.190002,234,237.789993,6236300,117392618.1,14.57885466,-9034577.795,254.850006,234.410004,28.13812381,25.12304959,18350576.4,-48.00636973,59.8623506,-7.020005,-6.011860474,-74.6539265,363533700
235.289993,236.940002,228.320007,230.970001,8289700,35945124.67,12.87705794,-25731683.88,247.5,230.970001,13.81644926,27.09589014,18171714.72,-92.7753694,54.82426647,-19.589997,-8.541218262,-53.80701891,355244000
234.949997,237.929993,230.5,233.979996,5912600,33658925.54,11.63710788,-30950501.19,247.5,230.970001,29.50985957,23.82147755,18279745.88,-84.56927459,56.56186489,-20.86,-4.423839749,-59.47442734,361156600
236.949997,241.5,235.020004,240.039993,6242300,47362342.5,11.01643898,-25911611.86,247.5,230.970001,61.10526735,34.81052539,18432880.07,-65.09830096,59.90551026,-12.620011,-4.198597176,-52.30990198,367398900
241.389999,241.550003,233.509995,235.839996,5071300,38144326.61,10.06957397,-24427652.02,244.190002,230.970001,47.38494877,46.00002523,18323658.1,-76.26265574,56.65077161,-17.100006,-7.455658569,-42.0131266,362327600
236.160004,239.25,233.360001,234.910004,3817900,11319070.12,9.138787789,-30135190.79,241.550003,230.970001,49.81102791,52.76708134,18303660.35,-79.1982372,55.92620286,-11.300003,-7.025251215,-35.6790269,358509700
236.020004,236.199997,227.5,228.889999,8216900,7621966.444,7.825165307,-30906881.38,241.550003,228.889999,9.893229204,35.69640196,18205819.58,-95.72308,51.34795554,-9.949997,-9.50818487,11.62597981,350292800
229.75,229.899994,210.270004,220.169998,11328800,111057103.7,6.011185616,4498323.551,241.550003,220.169998,31.6495982,30.4512851,17892781.1,-79.03875749,45.53337817,-14.240006,-10.57634063,45.01235232,338964000
224.139999,227.050003,217.899994,220.440002,7865400,120835890.7,4.543011698,21684764.73,241.550003,220.169998,32.51278237,24.68520326,17906674.1,-78.46707842,45.7382711,-21.050003,-7.703899811,1.776633325,346829400
221.949997,222.600006,211.350006,212.960007,6907300,19498156.21,2.744266015,-5499585.28,239.25,212.960007,9.282275263,24.48155194,17639784.46,-93.96589753,41.12300098,-24.829986,-9.150632069,-21.59793873,339922100
212.369995,213.600006,203,207.320007,9495700,40597712.11,0.853804116,-9406998.381,236.199997,207.320007,13.01207045,18.2690427,17456852.59,-90.2921191,38.0086848,-23.649994,-14.14965311,-2.652136472,330426400
212.800003,216.720001,210.270004,212.369995,9684800,49202111.7,-0.234208918,-7412540.383,229.899994,207.320007,34.83270294,19.04234955,17688152.85,-78.94383146,42.22754062,-21.610001,-10.69010419,55.29721149,340111200
216.5,216.75,206.389999,208.449997,8380000,24355446.39,-1.396678127,-13828515.58,227.050003,207.320007,22.66110736,23.50196025,17509387.5,-87.75281573,39.95448752,-31.589996,-9.750185696,1.089303594,331731200
209.020004,218.160004,208.580002,216.970001,7371400,71479457.34,-1.611869603,-202091.4471,222.600006,207.320007,71.27549349,42.92310126,17851904.34,-66.08400019,46.67336344,-18.869995,-7.269850111,24.67273281,339102600
220,230.889999,218.050003,230.289993,10782300,192401775.6,-0.699534565,43866009.83,230.889999,207.320007,97.8486697,63.92842351,18304441.5,-29.20884338,55.1271056,-4.620011,-4.061823148,72.72960287,349884900
230.300003,235.729996,222,225.399994,10923700,160393271.4,-0.366855642,47721526.3,235.729996,208.449997,64.79208229,77.97208182,18075489.15,-41.8936647,51.87579077,-3.490005,-4.42673091,115.4023623,338961200
226.009995,228.270004,211.25,212.229996,11345600,29348189.92,-1.152627203,3264300.173,235.729996,208.449997,19.90455895,60.84843698,17437223.35,-76.05708098,44.29804522,-7.940002,-9.654764639,197.1686005,327615600
205.809998,216.199997,203.509995,207.520004,9855500,33205768.85,-2.130850697,-13992089.96,235.729996,207.520004,12.44571346,32.3807849,17185431.96,-88.27495811,41.93860792,-12.919998,-9.336360301,19.94182721,317760100
210.050003,216.490005,206.419998,215.460007,6889300,94354127.75,-2.239591363,-323218.0969,235.729996,207.520004,37.08880084,23.14635775,17562517.05,-65.6275669,47.05790339,2.5,-2.139251961,-39.18773392,324649400
216.759995,218.449997,210.889999,216.929993,5157900,91691314.57,-2.182000793,4450717.845,235.729996,207.520004,41.65114086,30.39521838,17609519.62,-58.04218597,47.97250691,9.609986,-1.592274074,-34.42291555,329807300
216.820007,217.5,203.789993,204.190002,7211500,26000214.65,-3.128309449,-14902632.68,228.270004,204.190002,2.746392378,27.16211136,17306603.47,-96.36418532,41.31145485,-8.179993,-4.118146465,4.404036309,322595800
200.610001,207,198.600006,203.779999,9067200,39375839.66,-3.866775906,-17209246.97,218.449997,203.779999,26.09569445,23.49774256,17292123.15,-86.04903206,41.11360372,-4.669998,-1.707509107,-4.512568847,313528600
207.600006,208.440002,194.410004,198.089996,7703000,66156702.26,-4.855184043,-8067201.358,218.449997,198.089996,15.30779148,14.7166261,17038946.21,-91.0939189,38.3673538,-18.880005,-6.724113263,-20.46299356,305825600
199.089996,199.289993,184.320007,193.910004,13659300,148748131.2,-5.907694805,22685199.38,218.449997,193.910004,28.09844656,23.16731083,16876401.52,-81.34604347,36.44160495,-36.379989,-6.975290578,62.99880668,292166300
197,199.990005,190.820007,199.110001,7202200,185098729.6,-6.250172766,44769535.57,217.5,193.910004,44.57503653,29.32709152,17242696.8,-71.23128348,40.44620861,-26.289993,-8.231552711,-2.295357734,299368500
199.610001,202.289993,194.080002,198.119995,5926800,79948936.77,-6.526243752,16277326.7,208.440002,193.910004,57.21389246,43.29579185,17206886.33,-73.15699095,39.93037525,-14.110001,-13.96934256,-45.032136,293441700
197.080002,206.199997,194,204.380005,5258200,74729630.69,-6.16879152,1480977.804,208.440002,193.910004,83.1675048,61.6521446,17394155.81,-60.98034956,44.73036276,-3.139999,-9.325638669,-51.86429506,298699900
206.360001,219.330002,205.009995,218.639999,9804700,186961390.8,-4.680887354,31003397.11,219.330002,193.910004,98.02912568,79.47017431,17761030.74,-33.24256109,53.7889422,3.179992,3.020309627,-13.58147652,308504600
216.330002,216.740005,207,207.990005,7295600,133834293.6,-4.311379197,23358183.46,219.330002,198.119995,60.22448618,80.47370556,17283442.02,-53.9583679,47.52420258,-8.939988,0.226484672,-25.97432905,301209000
210.809998,212.800003,203.199997,207.860001,5495200,23448544.67,-3.983116668,-17015613.47,219.330002,198.119995,54.71772564,70.99044584,17278881.92,-46.43914538,47.45154976,3.669999,-3.527339531,-20.23572787,295713800
202,206.699997,197.649994,199.850006,6996700,32876904.19,-4.319513243,-28985360.24,219.330002,199.850006,23.09516596,46.01245926,17067121.48,-55.64124188,43.08147929,-3.929993,-7.873501844,35.6501677,288717100
200,203.789993,190.5,198.509995,7042000,63705647.69,-4.640742055,-21437896.41,219.330002,198.509995,27.78353952,35.19881038,17020208.02,-59.46875171,42.37833775,0.419999,-2.781726306,-2.350412536,281675100
198.210007,207.149994,195.529999,206.919998,5779100,119318216.6,-4.168647671,1293510.369,216.740005,198.509995,62.57619997,37.81830182,17318546.86,-35.44703163,48.10320191,13.009994,1.540876934,-36.26367567,287454200
203.600006,208.160004,201.279999,207.889999,4440600,94887651.95,-3.6738882,2701768.918,212.800003,198.509995,77.98204781,56.1139291,17345638.16,-32.67639141,48.73583802,8.779998,4.947247816,-42.35233026,291894800
207.080002,214.020004,205.690002,207.729996,5439900,36167774.7,-3.257152236,-15651337.97,214.020004,198.509995,73.25677326,71.27167368,17342220.45,-33.13341233,48.63052961,9.610001,7.127013416,-60.17438668,286454900
208.600006,211.360001,206.520004,210.910004,4086800,24550762.75,-2.639855304,-25432900.23,214.020004,198.509995,86.77721313,79.33867806,17425496.46,-24.05026907,50.90128074,6.529999,5.926373834,-43.25622726,290541700
209.479996,217.690002,208.520004,216.610001,5147000,58594107.34,-1.67143367,-16290393.31,217.690002,206.919998,95.12634994,85.05344544,17535945.21,-7.769212763,54.76143261,-2.029998,9.332730904,-13.15718432,295688700
216.600006,218.660004,206.850006,207.279999,5636700,38025293.6,-1.637924759,-17613954.55,218.660004,207.279999,34.52242965,72.14199757,17314249.45,-41.79674701,48.09591052,-0.710006,1.41892256,7.19828078,290052000
209.639999,210.199997,197.25,201.350006,10179300,31770955.98,-2.066053403,-18544159.34,218.660004,201.350006,19.14995439,49.59957799,17152991.28,-62.3655732,44.39702911,-6.509995,-7.907973417,3.820616643,279872700
182,194.399994,178,178.589996,20056600,27276944.06,-4.193550394,-18668777.88,218.660004,178.589996,1.45104757,18.3744772,16002353.28,-98.57247527,33.6881808,-21.26001,-14.13529895,174.9136466,259816100
179.860001,183.399994,177.220001,182.259995,8495200,33746938.46,-5.519839564,-14963961.99,218.660004,178.589996,12.1621468,10.92104959,16414513.55,-88.03136101,36.35404395,-16.25,-12.31598474,54.59309943,268311300
183.869995,187.190002,179.880005,184.669998,7002300,72375718.48,-6.303799905,202980.158,218.660004,178.589996,17.97779069,10.53032835,16526844.61,-82.02220931,38.11350288,-22.25,-7.595700548,0.080037732,275313600
183.759995,191.339996,183,190.160004,7097200,80938864.1,-6.408226475,9113822.81,210.199997,178.589996,39.2359144,23.12528396,16735014.15,-68.7741263,42.04399287,-17.729995,-4.206332784,0.783868219,282410800
188.949997,193.479996,187.100006,190.619995,5406700,66419653.3,-6.380319503,7310889.293,194.399994,178.589996,77.99766857,45.07045789,16752182.05,-67.66410948,42.37423214,-17.110001,-7.877442083,-6.443909951,287817500
189.979996,192.660004,185.300003,188.589996,6040400,33140418.84,-6.447682115,-4680148.047,193.479996,182.259995,69.92619001,62.38659099,16694603.64,-72.56275536,41.25696078,-22.320008,-9.28375732,36.02666306,281777100
188.949997,192.039993,187.720001,191.559998,4487700,33266717.54,-6.190057995,-9119918.459,193.479996,184.669998,85.8823583,77.93540563,16789730.64,-65.39576264,43.60001021,-25.050003,-7.784142065,-17.50399824,286264800
190.720001,196.889999,190,196.089996,4571700,44044936.64,-5.556306402,-6677671.326,196.889999,188.589996,94.24043875,83.34966236,16895855.47,-54.46430108,47.06793617,-11.190003,-7.02669751,11.86502887,290836500
196.940002,199.330002,193.070007,195.300003,5546100,36108177.4,-5.05947703,-7596841.684,199.330002,188.589996,71.27584257,83.79954654,16877437.34,-56.3706547,46.53060821,-6.050003,-9.837956651,7.754031475,285290400
196.179993,199.869995,194.789993,199.449997,5285400,32990371.73,-4.281511738,-8274273.023,199.869995,188.589996,97.11737659,87.54455264,16995288.24,-46.35619114,49.77436741,20.860001,-3.777500018,-6.232370004,290575800
200.350006,206.880005,199.559998,204.880005,6214500,55556239.81,-3.190039583,-619148.4541,206.880005,191.559998,89.56158882,85.98493599,17139182.78,-33.25289093,53.72970297,22.62001,1.75316558,-38.94963308,296790300
204.529999,207.759995,202.5,207.300003,4006800,50245487.52,-2.105495581,878994.8198,207.759995,195.300003,97.40995423,94.69630655,17212587.1,-27.41312784,55.41488578,22.630005,16.07593238,-80.02253622,300797100
208.520004,213.869995,207.699997,211.559998,5341100,37499240.22,-0.891958706,-2643661.149,213.869995,195.300003,88.89423879,91.95526061,17294926.45,-6.302857785,58.29439161,21.399994,16.07593756,-37.12802524,306138200
210.020004,212.770004,205.259995,210.240005,5495100,44131430.79,-0.036315768,-1734172.397,213.869995,199.449997,80.97489717,89.09303006,17261601.56,-9.904476383,57.06457075,19.62001,13.8463244,-21.52435628,300643100
210.570007,212.490005,207.720001,210.240005,3692500,33077814.73,0.634473608,-4721516.434,213.869995,204.880005,74.63318825,81.50077474,17261601.56,-9.904476383,57.06457075,21.650009,10.55952912,-47.97243984,300643100
210.300003,214.800003,207.020004,207.770004,5581100,6706119.796,0.955753255,-13905376.8,214.800003,207.300003,42.84555053,66.15121198,17218220.28,-20.13172796,54.56632777,16.210006,8.996962255,3.225627462,295062000
207.330002,209.350006,201.669998,204.699997,4668100,10460695.98,0.95167546,-15203647.54,214.800003,204.699997,23.07690667,46.85188182,17135754.02,-31.76102216,51.54576391,8.610001,8.542341239,-22.71869413,290393900
203.490005,208,202.589996,204.940002,3860800,18207110.64,0.956781,-11887840.22,214.800003,204.699997,24.90481915,30.27575878,17141227.24,-33.4237322,51.77053546,9.639999,6.984758895,-13.96929385,294254700
204.350006,206.259995,200.399994,203.990005,3427400,17865894.45,0.874094343,-9559229.636,214.800003,203.990005,24.93061636,24.30411406,17123330.54,-36.64406102,50.7666714,4.540008,4.028766975,-25.03007634,290827300
204.470001,209.199997,204.050003,206.899994,4054600,20721507.74,1.031486035,-6828991.107,214.800003,203.990005,45.13886068,31.65809873,17172223.61,-29.17285235,53.72657581,2.019989,5.939575434,-26.8927715,294881900
209.75,210.809998,207.179993,208.169998,3073800,10552366.34,1.244354648,-8326893.872,210.809998,203.990005,74.6397792,48.23641875,17197111.76,-26.7338879,54.99816587,0.869995,4.372023631,-41.84356908,297955700
207.949997,209.990005,204.199997,205.309998,2805700,1654099.397,1.168803224,-11013948.68,210.809998,203.990005,47.16620666,55.64828218,17154881.52,-43.67237343,51.56187575,-6.25,0.209875532,-54.85236141,295150000
204.429993,206.970001,201.550003,202.300003,3514700,454186.5135,0.856177256,-11493720.77,210.809998,202.300003,18.25176052,46.68591546,17113747.9,-62.4687344,48.15198667,-7.940002,-2.411963303,-12.28162124,291635300
201.5,205,199.25,204.470001,3977500,20003609.59,0.774590629,-4424836.492,210.809998,202.300003,45.15572581,36.85789766,17151448.8,-66.43086821,50.68406457,-5.770004,-3.351293755,-25.53032147,295612800
205.100006,209.880005,202.710007,203.520004,5993700,19934222.18,0.626059003,-1152840.142,210.809998,202.300003,36.93775726,33.44841453,17132968.77,-72.5401725,49.54334767,-4.25,-3.196347432,9.073538243,289619100
204.779999,206.789993,201.580002,206.419998,3544300,16440983.52,0.733892047,-820977.5619,209.990005,202.300003,66.75972683,49.61773663,17218374.1,-53.890697,53.01938689,1.720001,-1.816974367,-4.013540961,293163400
206.759995,225.490005,206.259995,224.610001,13246400,259368031.8,2.261067555,76684388.63,225.490005,202.300003,96.64632686,66.78127032,17530702.5,-3.353673141,67.93914283,19.669999,8.105114634,137.3438928,306409800
224.110001,235.539993,222.850006,231.669998,13304900,355756927.5,3.994996074,132089015.4,235.539993,203.520004,89.33591693,84.24732354,17947066.62,-10.66408307,71.69617259,27.679993,13.17537928,185.0174589,319714700
231.5,231.710007,226.119995,227.119995,6940200,114533125.7,4.944996856,65993424.36,235.539993,203.520004,75.20612417,87.06278932,17685758.14,-23.20198298,66.30357169,20.220001,10.82267629,79.76067136,312774500
228.880005,235.309998,227,227.789993,8793100,230842.513,5.686393357,-3413991.565,235.539993,206.419998,77.17902811,80.57368974,17706231.54,-21.3557495,66.70074796,19.619995,11.66723242,156.5530723,321567600
228.520004,231.289993,226.199997,229.589996,4903900,13975679.62,6.34604734,-27124214.31,235.539993,224.610001,79.67897061,77.35470763,17775714.87,-16.39569619,67.7988806,24.279998,10.96665184,20.94657919,326471500
229.509995,238.990005,228.220001,237.220001,7791100,83825839.01,7.399212001,-12132962.51,238.990005,227.119995,89.03343179,81.96381017,17938687.05,-4.453960184,72.01220822,34.919998,13.95494225,153.46802,334262600
238.970001,241.880005,231.630005,232.5,8075900,68475021.42,7.763495209,-9781532.145,241.880005,227.119995,40.48223954,69.73154731,17783666.39,-22.00329322,66.23835485,28.029999,13.24338915,187.839042,326186700
233.050003,237.550003,230.240005,236.889999,5801600,37692346.52,8.310628751,-17724840.63,241.880005,227.789993,68.17599838,65.89722324,17936153.24,-11.70538451,68.74817189,33.369995,17.09836653,65.06671978,331988300
237.169998,240.399994,234.210007,235.600006,5121400,41204173.41,8.541681187,-18245627.31,241.880005,229.589996,59.9490064,56.20241477,17904560.42,-14.73140573,67.1680563,29.180008,15.22472971,28.7592709,326866900
234.690002,240,234.5,239.059998,5635000,27879896.16,8.901374837,-21039525.77,241.880005,232.5,79.35573811,69.16024763,17979772.66,-6.615075462,69.21205595,14.449997,17.46265394,-5.984617181,332501900
239.550003,244.490005,239,240.059998,4828600,25954515.68,9.161518012,-20882421.13,244.490005,232.5,68.91223158,69.4056587,18003344.15,-9.792233666,69.7973034,8.39,16.29687062,36.23564597,337330500
242.460007,243.440002,238.699997,239.720001,4336100,2241828.56,9.233806858,-26464695.04,244.490005,235.600006,66.52628772,71.5980858,17996505.4,-11.11629845,69.31486155,12.600006,6.727216033,-67.26582317,332994400
240.660004,242.330002,227.070007,229.429993,8027400,13178430.47,8.364359511,-22862643.3,244.490005,229.429993,13.54756757,49.66202896,17810377.82,-35.09673956,56.57041445,1.64,-0.966894729,-39.6658374,324967000
231.289993,231.899994,224,229.25,5166700,37550647.7,7.573489818,-11555858.17,244.490005,229.25,25.62224851,35.2320346,17804080.14,-39.86398382,56.37515728,-0.339996,0.937832444,-25.55401862,319800300
227.5,229.779999,220.399994,222.660004,5893700,34238187.8,6.341857302,-6933787.111,244.490005,222.660004,9.381523321,16.1837798,17655558.74,-90.61847668,49.62201027,-14.559997,-2.252069519,-32.97358156,313906600
218.649994,220.960007,214.270004,219.070007,7836200,44246113.89,5.018249647,-1228255.46,243.440002,219.070007,16.45527367,17.15301517,17560533.29,-84.11646975,46.36371608,-13.429993,-4.58207639,59.79526499,306070400
221.270004,224.220001,219.210007,223.059998,4115400,50291352.44,4.242336953,3140970.253,242.330002,219.070007,31.32571143,19.05416947,17703256.47,-70.91332327,50.27194443,-13.830001,-5.969143808,-47.1781905,310185800
217.179993,222.220001,216.039993,219.460007,4863900,29353768.73,3.298903657,-2019120.431,231.899994,219.070007,29.43849089,25.73982533,17636837.56,-82.82593373,46.94800877,-16.139999,-5.60859914,-39.77265692,305321900
220.610001,221.600006,217.600006,218.130005,3302300,13347856.07,2.416055147,-9039300.611,229.779999,218.130005,24.88718404,28.55046212,17607360.68,-87.2269991,45.74462929,-20.929993,-7.919284934,-43.07949531,302019600
219.990005,228.789993,215.449997,226.699997,7203200,78792934.11,2.380477413,9733996.021,228.789993,218.130005,85.60607725,46.64391739,17737102.96,-58.86832366,53.93765429,-13.360001,-3.777592858,40.64904128,309222800
226.729996,227.649994,218.100006,219.580002,5718500,83538538.14,1.757498362,18039037.19,228.789993,218.130005,30.959567,47.15094276,17510871.16,-82.42886226,47.51758311,-20.139999,-8.148580341,1.481810115,303504300
221.820007,224.800003,216.820007,217.160004,4044500,1134012.133,1.056332618,-6422980.344,228.789993,217.160004,12.81864702,43.12809709,17447847.39,-90.43679714,45.53376718,-12.269989,-9.539279426,-16.23866131,299459800
216.160004,220.550003,213.600006,215.399994,4649400,2426556.338,0.354548601,-15434997.97,228.789993,215.399994,11.84983239,18.54268214,17415068.06,-94.17291014,44.09201124,-13.850006,-10.14517224,7.225386868,294810400
215.949997,221.210007,215.929993,220.020004,4253700,21362604.02,0.169225184,-11693444.74,228.789993,215.399994,42.2646708,22.31105007,17514790.78,-79.21658075,48.68519008,-2.64,-4.101464188,-47.01023993,299064100
217.25,223.210007,216.720001,220.539993,3822200,29467291.47,0.063580887,-6521004.704,227.649994,215.399994,49.39496745,34.50315688,17524843.86,-76.74266779,49.19114846,1.469986,-3.799348746,-26.02241276,302886300
222.190002,223.300003,219.110001,219.580002,2730000,11887637.66,-0.096493909,-9405714.112,224.800003,215.399994,53.39283573,48.35082466,17508206.16,-79.18553139,48.24537859,-3.479996,-1.383275822,-53.67935253,300156300
220.009995,224.75,219.429993,222.490005,3083300,6984449.041,0.011328002,-11290863.06,224.75,215.399994,79.73097564,60.83959294,17544385.72,-51.42073864,51.30186056,3.029998,1.561143877,-60.65312269,303239600
223.25,225.100006,220.800003,223.539993,3245500,15840308.03,0.179434491,-8217844.94,225.100006,219.580002,82.98788671,72.03723269,17558936.61,-38.56618479,52.39432427,5.409988,0.215186499,-21.13767799,306485100
222.720001,226.970001,221.75,223.570007,3087100,11322984.1,0.311491296,-7650954.695,226.970001,219.580002,66.82932683,76.51606306,17559372.38,-34.36465087,52.42717748,-3.12999,1.872778579,-36.5303563,309572200
224.25,232,221.399994,224.820007,6514300,21474273.82,0.511119946,-3493547.892,232,219.580002,44.29795534,64.70505629,17576632.63,-39.02171381,53.85544749,5.240005,3.066979254,97.2655422,316086500
226.610001,228.300003,224.860001,225.009995,3382400,15138903.16,0.676855168,-3490995.056,232,222.490005,44.3913993,51.83956049,17582137.65,-37.98917,54.08110183,7.849991,-0.745479498,-53.04309196,319468900
221.919998,229.600006,221.039993,228.919998,4927800,35712045.97,1.110900323,3373412.457,232,223.539993,72.49997478,53.72977647,17640913.68,-16.73914676,58.57125018,13.520004,4.253573146,-13.82705255,324396700
229.259995,231.399994,221.5,223.300003,7749100,46047857.6,0.989985668,9163572.645,232,223.300003,20.62051603,45.8372967,17519936,-47.28260781,50.87133582,3.279999,2.82740785,91.59599456,316647600
226.089996,237.5,226,233.270004,11895800,89715165.88,1.679297792,24593366.02,237.5,223.300003,74.3013718,55.80728754,17865921.37,-17.69873248,60.73341508,12.730011,8.296198003,155.8566697,328543400
234.380005,240.5,233.270004,238.520004,5959700,111763242.5,2.61902327,35685090.79,240.5,223.300003,89.82530685,61.58239823,18133649.53,-7.360581567,64.74655151,18.940002,8.408326363,40.10626043,334503100
237.470001,242.990005,235.690002,238.490005,5388600,41422668.19,3.323035924,14597423.56,242.990005,223.300003,79.49887226,81.20851697,18132899.97,-15.31133091,64.70585693,16,8.139118786,40.98163361,329114500
238.899994,251.419998,238.580002,248.929993,9249300,105702852.7,4.669562989,25096398.09,251.419998,223.300003,91.67779022,87.00065644,18368787.93,-7.016073962,71.4346523,25.39,13.36642259,238.8021978,338363800
250.119995,256.690002,249.119995,252.389999,7478900,114144276.5,5.947331819,29795849.95,256.690002,233.270004,85.98891261,85.72185836,18497348.71,-10.75807579,73.25454666,28.819992,13.43880324,142.5615412,345842700
251.160004,251.759995,246.5,248.130005,5090100,24991926.74,6.540828311,642982.6107,256.690002,238.490005,63.45005239,80.37225174,18371115.22,-22.77806485,67.54845307,23.309998,11.00027412,56.83561855,340752600
255.479996,263.73999,255,259.320007,8101300,35684832.84,7.823928818,-7939355.052,263.73999,238.490005,84.24247811,77.89381437,18600665.17,-9.975137213,73.40796828,34.310012,15.99051701,162.4242817,348853900
258.079987,260.299988,254.580002,259.959991,6382300,64858026.4,8.791098267,-1446172.049,263.73999,248.130005,84.97614943,77.55622664,18620658.62,-8.80298124,73.70044967,31.039993,15.6302744,-2.026311346,355236200
262.01001,265.640015,259.609985,260.309998,6932600,32682439.23,9.476589438,-8896086.551,265.640015,248.130005,72.15249309,80.45704021,18629251.67,-11.95070487,73.86972087,37.009995,15.68819332,104.9609745,362168800
262.48999,263,256.5,261.380005,4126600,17834456.62,9.991016533,-15859401.81,265.640015,248.130005,77.7429119,78.29051814,18657748.2,-9.551587217,74.41193002,28.110001,14.17962925,-16.25877674,366295400
261.480011,262.089996,258.5,262.01001,3867900,32599546.02,10.33045678,-12568283.99,265.640015,259.320007,67.17901688,72.35814062,18667694.55,-8.139020649,74.74422634,23.490006,17.3354261,-50.08581642,370163300
263.25,267.26001,259.75,259.940002,5849200,8900333.392,10.31354514,-17620004.9,267.26001,259.940002,42.27126671,62.39773183,18637136.24,-15.83731135,71.46050138,21.449997,11.43310222,-50.8297046,364314100
258.869995,259.329987,251.619995,256.76001,5334800,21052842.91,9.929087427,-14218091.8,267.26001,256.76001,32.86451452,47.43826603,18565579.69,-22.94579918,66.61852338,7.830017,7.647159858,-10.48542712,358979300
254.669998,258.73999,253,255.710007,3027900,32249984.41,9.430961204,-7971119.433,267.26001,255.710007,26.15094679,33.76224267,18543763.38,-27.99321425,65.05119067,3.320008,7.220429217,-43.80915266,355951400
256.519989,258.799988,253.259995,254.339996,2915600,7408921.26,8.823927403,-12594867.25,267.26001,254.339996,17.39129406,25.46891845,18527540.88,-38.01121424,62.96950722,6.209991,2.173302998,-68.47761452,353035800
254.539993,256.950012,252.610001,256.779999,2833400,12505914.69,8.442417657,-11719641.88,267.26001,254.339996,32.9923213,25.51152072,18555511.6,-33.19609865,65.11091793,-2.540008,1.739371614,-62.1147495,355869200
258.190002,263.679993,258.190002,262.549988,4318100,29642339.32,8.507588145,-4843674.399,263.679993,254.339996,90.63013941,47.00458492,18619179.67,-16.42266627,69.5894354,2.589997,5.811462826,-15.16669614,360187300
264.980011,265.5,261.660004,261.73999,3818000,14504975.28,8.397079847,-6406878.588,265.5,254.339996,70.83002101,64.81749391,18605857.81,-26.58967891,68.26468379,1.429992,0.933203353,-52.87176132,356369300
263.5,264.23999,260.290009,263.25,2985100,4654623.166,8.335262693,-9598130.648,265.5,254.339996,82.54460687,81.33492243,18627884.32,-19.31603116,69.43290703,1.869995,1.265582826,-53.22845996,359354400
261.890015,264.480011,261.640015,263.859985,2844900,13782204.8,8.240501473,-7126855.002,265.5,256.779999,87.27684153,80.21715647,18634801.19,-21.73926943,69.91470099,1.849975,1.363753612,-58.96344806,362199300
268.700012,272,267.51001,269.700012,6447100,16511144.4,8.538220602,-4599683.73,272,261.73999,83.34548636,84.38897825,18697767.52,-11.28551244,74.12045811,9.76001,3.183107675,56.23273397,368646400
275.5,284.890015,274.299988,284.119995,9852400,106850899.5,9.824486706,25596779.68,284.890015,261.73999,96.86983816,89.16405535,19042473,-2.314456078,81.13360995,27.359985,8.438603166,154.7222007,378498800
287.670013,288,280.100006,281.190002,6772300,97578134.3,10.48655345,32672473.07,288,263.25,75.42403388,85.21311947,18940869.93,-18.71906835,76.59183461,25.479995,8.17496339,15.78164535,371726500
284.01001,291.420013,280.399994,286.040009,8341700,44518755.07,11.27265698,15714320.33,291.420013,263.859985,81.93416937,84.74268047,19057679.57,-13.51759188,78.7157787,31.700013,11.40364459,56.36387493,380068200
282.549988,282.899994,272.51001,277.390015,11169900,91560458.53,11.07005871,22316134.37,291.420013,269.700012,41.32163848,66.22661391,18805422.36,-35.25123531,67.03354216,20.610016,8.478357282,268.8992371,368898300
277.619995,284.880005,277.519989,282.109985,5501600,71767323.14,11.16169519,16690321.18,291.420013,277.390015,50.7666498,58.00748588,18995485.41,-23.39201957,69.67796366,19.559997,10.91845146,88.69529428,374399900
282.98999,285.48999,277,278.480011,4558800,26164720.01,10.81672076,-1638368.95,291.420013,277.390015,31.57059785,41.21962871,18924695.06,-33.34191703,65.33718378,16.740021,8.450818632,60.89503776,369841100
279.5,281.410004,273.660004,281.100006,3781300,30964612,10.63217664,-7460288.467,291.420013,277.390015,45.42567233,42.58763999,18967585.15,-26.59109459,66.93814623,17.850006,7.06532807,-12.43139344,373622400
280.459991,284.790009,278.630005,280.309998,3766100,31569663.41,10.30340579,-8971258.414,285.48999,277.390015,60.09245007,45.69624008,18956958.12,-28.62667242,65.94904325,16.450013,7.094830255,-1.359350445,369856300
280.5,282.390015,277,279.200012,3324600,8934577.985,9.839858177,-15975886.17,285.48999,278.480011,46.83021603,50.78277947,18942044.93,-36.77399023,64.5067821,9.5,6.058883951,11.37315333,366531700
274.369995,274.399994,249.130005,253.860001,16455400,69805214.66,7.343119331,1978867.431,285.48999,253.860001,13.00879525,39.97715378,18640306.4,-88.81533435,41.95120901,-30.259994,-3.789882729,478.4175191,350076300
255.149994,262.459991,252.419998,260.73999,8300100,132093505.8,5.852133667,28963098.61,284.790009,253.860001,32.55744166,30.79881765,19086272.56,-72.54674201,47.33554003,-20.450012,-3.322217872,28.74160475,358376400
262.410004,264.700012,259.5,261.380005,5177700,74063174.54,4.668346852,18904896.98,284.790009,253.860001,34.35221151,26.63948281,19106646.07,-71.0333467,47.82041115,-24.660004,-8.003657046,-47.44732248,363554100
263.359985,265.600006,262.320007,263.820007,3692600,9963329.779,3.882322049,-7323854.018,282.390015,253.860001,44.1671605,37.02560456,19154980.29,-65.26365755,49.72096563,-13.570008,-6.177316006,-45.47494943,367246700
257.98999,261.429993,255.270004,259.320007,6810900,28786211.9,2.863273306,-11398893.84,274.399994,253.860001,40.32452092,39.61463098,19091995.3,-75.90446897,46.36673298,-22.789978,-9.341351265,-18.35117542,360435800
255,256.019989,244.710007,250.029999,8214100,64599818.94,1.291160139,-634453.9032,265.600006,250.029999,25.46669342,36.65279161,18847998.26,-88.61059448,40.31949609,-28.450012,-9.863374498,-26.46218856,352221700
245.220001,253.800003,245,250.410004,5658700,67782302.03,0.075047257,4839466.499,265.600006,250.029999,27.28576962,31.02566132,18860482.36,-87.79705359,40.66041641,-30.690002,-11.23674548,2.855532936,357880400
251.119995,252.839996,247.039993,252.139999,3749500,47103654.26,-0.740597676,59276.32703,265.600006,250.029999,35.56722047,29.4398945,18899576.33,-81.78029648,42.27704111,-28.169999,-9.458492875,-17.75247872,361629900
252.520004,254.960007,246.100006,246.949997,4834200,18408547.99,-1.785213123,-11031905.86,261.429993,246.949997,13.3970806,25.41669023,18822397.33,-94.50713356,38.8569275,-32.250015,-12.14870447,27.84492106,356795700
248.25,249.729996,246.070007,246.600006,3795400,-1495634.895,-2.611219229,-20899456.23,256.019989,246.600006,16.71089309,21.89173138,18815546.04,-95.3653757,38.62997529,-7.259995,-12.02596848,0.777993149,353000300
244,248.639999,241.380005,245.259995,4852700,15334942.85,-3.335512991,-17681046.99,254.960007,245.259995,28.57135073,19.5597748,18794922.04,-91.06199115,37.72154502,-15.479995,-12.15616602,45.96342417,348147600
246.919998,247.649994,240.119995,242.679993,4238300,24621824.94,-4.070780195,-11802140.09,254.960007,242.679993,17.25064643,20.84429675,18743874.28,-94.26909067,35.96775781,-18.700012,-4.40400534,-74.24371331,343909300
242.199997,242.660004,235.649994,240.240005,5941700,33273919.87,-4.795096503,-5571271.599,254.960007,240.240005,23.77010829,23.19736848,18701260.95,-90.17969846,34.34160861,-23.580002,-7.862232794,-28.41411549,337967600
250.199997,252.789993,245.360001,251.419998,8998200,78091184.46,-4.416084523,11744238.03,252.789993,240.240005,92.00702987,44.34259486,18977768.46,-59.30321548,46.31773523,-7.900009,-3.810546641,73.78758908,346965800
253.059998,256.5,251.029999,255.210007,5406300,74193319.5,-3.766475164,16519967.84,256.5,240.240005,93.81298499,69.86337438,19113411.04,-34.69113468,49.66926301,5.180008,-3.263588724,46.40903428,352372100
259.130005,262.48999,257.799988,260.619995,7713300,39999524.18,-2.783033175,6092016.263,262.48999,240.240005,93.03280448,92.95093978,19228014.77,-16.62774292,54.07669735,10.209991,0.50130648,13.24935031,360085400
258.529999,261.459991,255.729996,259.570007,4485500,34420987.39,-2.064574441,-502772.5634,262.48999,240.240005,89.12077707,91.98885551,19196939.36,-20.13354452,53.10471504,7.430008,3.81554535,-45.39267844,355599900
260.100006,262.880005,252.639999,259.279999,5055100,47533548.59,-1.501286049,1017244.439,262.880005,251.419998,79.45202524,87.20186893,19191927.88,-13.22072914,52.82230775,12.330002,3.542188754,-10.66676092,350544800
262.25,265.540009,254.399994,257.01001,7361300,45365182.71,-1.223936305,856658.2105,265.540009,255.210007,41.21300399,69.9286021,19147670.62,-28.5379549,50.5560245,10.410004,1.931471016,96.32751033,343183500
244.639999,245.889999,235.199997,236.910004,12888300,24788941.24,-2.596110787,-5833900.097,265.540009,236.910004,5.636144771,42.10039133,18571964.74,-94.36385523,35.87765095,-8.349991,-4.065597539,166.6066774,330295200
238.570007,238.960007,221,224.589996,11268700,42650806.69,-4.624383618,-2357271.298,265.540009,224.589996,8.060160024,18.30310293,17901735.73,-91.93983998,30.10758889,-18.089997,-8.925389077,196.9041471,319026500
228.25,232.470001,223,227.059998,7105300,56226772.06,-5.963749537,3598908.675,265.540009,224.589996,13.6057404,9.100681733,18025666.94,-86.3942596,32.45307604,-13.180007,-7.420695332,46.41951903,326131800
220,230.990005,217.320007,229.699997,9147300,137168674.1,-6.734549132,31462595.8,265.540009,224.589996,25.67397239,15.77995761,18108279.4,-74.32602761,34.96519399,-21.720001,-5.348605725,115.8247411,335279100
219.720001,229.919998,219.100006,226.350006,5399300,149743729.8,-7.5289407,44002294.99,245.889999,224.589996,31.60658568,23.62876616,17974873.34,-81.27333342,33.27410896,-28.860001,-5.781717745,-9.12870054,329879800
233.380005,234.770004,226.550003,227.479996,10549400,37818462.36,-7.975385709,9519378.212,238.960007,224.589996,46.95004159,34.74353322,18001827.85,-78.92992829,34.42617054,-33.139999,-9.521916391,17.23900336,340429200
226.720001,232.399994,225.509995,230.470001,3494400,16808414.92,-7.995758058,-12137682.68,234.770004,226.350006,75.35814476,51.30492401,18140489.54,-72.7291716,37.50110354,-29.100006,-9.693979594,-35.36429721,343923600
234.270004,235.389999,230.800003,235.339996,4130300,35059948.61,-7.532109921,-14086657.53,235.389999,226.350006,99.72328156,74.0104893,18214328.69,-62.62963863,42.25106792,-23.940003,-9.699946084,-46.45223186,348053900
233.190002,237.389999,230.559998,231.100006,4116600,17138410.25,-7.421249643,-19305667.86,237.389999,226.350006,65.60964785,80.23035806,18139915.37,-71.42264946,39.44057653,-25.910004,-10.9681397,-8.22427823,343937300
234.660004,236.279999,232,235.289993,3492400,9114017.251,-6.915576678,-22238872.78,237.389999,227.479996,82.32318777,82.55203906,18214551.89,-62.73333626,43.44420877,-1.620011,-9.25254786,-30.91333505,347429700
236.270004,237.800003,231.199997,235.240005,3463300,23330566.34,-6.444571811,-16893657.1,237.800003,230.470001,79.17008679,75.70097414,18213809.92,-62.83700279,43.40733874,10.650009,-8.470489146,-52.95260348,343966400
234.25,234.610001,220.309998,221.669998,9553300,16996174.77,-7.084616171,-15186679.17,237.800003,221.669998,7.775869704,56.42304809,18014026.7,-90.97886599,34.77851638,-5.39,-6.432825015,-25.87618227,334413100
229.600006,244.600006,228.25,242.770004,10516300,155867416.9,-5.822147699,31078541.47,244.600006,221.669998,92.46602965,59.80399538,18923372.53,-47.22107851,51.06690842,13.070007,8.09475414,-6.676901506,344929400
241.130005,241.5,235.639999,238.100006,4962500,160848187.5,-5.139220416,48764691.37,244.600006,221.669998,73.24002528,57.82730821,18721077.77,-27.26634645,48.19788359,11.75,4.862154539,-30.15776955,339966900
238.139999,240.5,235.059998,238.660004,3228400,19858827.42,-4.500924607,6706529.798,244.600006,221.669998,75.54549179,80.41718224,18732749.29,-21.77420168,48.57101103,11.180008,3.900743194,-64.70652542,343195300
242.509995,243.119995,238.75,241.699997,3775300,20440670.8,-3.707036147,-10923634.3,244.600006,221.669998,88.0608973,78.94880479,18773871.87,-10.63053191,50.64915243,11.229996,6.781528868,-30.07797307,346970600
243,247.559998,241.320007,242.589996,4203800,11900922.15,-2.971801266,-19860109.24,247.559998,238.100006,74.26202737,79.28947216,18787773.45,-16.43519669,51.26997199,7.25,6.642342301,-60.15128822,351174400
240.490005,242.350006,236.529999,238.929993,3682600,8664764.891,-2.653861911,-22740161.83,247.559998,238.100006,30.95996,64.42762822,18724349.89,-30.32328681,48.56436275,7.829987,3.670756265,5.385760073,347491800
241,241.360001,230.529999,230.970001,9045900,1976041.703,-3.009505803,-23979307.82,247.559998,230.970001,2.583687762,35.93522504,18601663.47,-60.88072294,43.22211658,-4.319992,-1.856885814,119.0131467,338445900
234.490005,246.690002,228.5,241.220001,15354700,185996246.8,-2.436183999,36245589.34,247.559998,230.970001,66.73663345,33.4267604,19003102.94,-23.26604404,50.73701093,5.979996,4.379054408,272.9947044,353800600
242.190002,242.839996,237.199997,240.199997,5161000,203761628.6,-2.04060531,63240615.17,247.559998,230.970001,61.38509039,43.56847053,18938175.26,-27.00917798,50.02740965,18.529999,2.086788281,47.7780323,348639600
239.110001,242.880005,236.800003,241.929993,4577200,35833007.18,-1.569418846,15103053.9,246.690002,230.970001,73.8317291,67.31781764,18975346.41,-20.66056881,51.27219444,-0.840011,2.843898936,32.16296596,353216800
242.550003,251.820007,242,251.080002,7948800,94341917.13,-0.452455299,12653881.65,251.820007,230.970001,96.82673766,77.34785238,19148460.21,-2.348476003,57.32671297,12.979996,13.26747159,-16.79524353,361165600
249.720001,252.339996,245.580002,249.100006,5870800,89427553.49,0.269866378,8937933.51,252.339996,240.199997,86.40943564,85.6893008,19085776.63,-10.11548611,55.71350371,10.440002,2.607406968,-44.17428183,355294800
250.619995,255.75,250.25,251.699997,6236000,22301644.54,1.040119209,-14753010.26,255.75,240.199997,78.62794912,87.28804081,19147053.34,-11.42777306,57.40842517,10,5.711881838,25.66246851,361530800
250,258.850006,248.5,258.679993,6101100,66459150.64,2.188549236,-9053461.655,258.850006,241.929993,99.22896609,88.08878362,19319986.41,-0.55559793,61.6516228,16.089997,8.388497722,88.98215834,367631900
257.48999,259,252.020004,253.979996,4025700,67003998,2.688447084,-5725425.642,259,249.100006,70.47056471,82.77582664,19209134.58,-16.45902951,57.49780077,15.050003,5.080678176,6.63258549,363606200
255.860001,259.98999,255.509995,257.700012,4473000,12504605.2,3.346220781,-21184179.02,259.98999,249.100006,84.10839759,84.6026428,19268098.55,-7.272082335,59.80611671,26.730011,6.228622882,6.403729959,368079200
250.610001,251.880005,245.600006,247.740005,7918500,19234967.19,3.028906501,-23440901.22,259.98999,247.740005,14.87144809,56.48347013,19095218.81,-38.90120321,51.708692,6.520004,3.687277553,115.0247108,360160700
247.949997,250.929993,246,248.710007,3587200,19831437.17,2.823160071,-22043328.83,259.98999,247.740005,21.6122617,40.19736912,19126222.93,-35.82085291,52.38484378,8.51001,7.680653731,-60.34446545,363747900
252.210007,252.779999,242.169998,242.779999,7485100,5617173.053,2.15674089,-23990376.09,259.98999,242.779999,3.423127238,13.30227901,19040693.1,-54.65225934,47.96350798,0.850006,0.646711713,-51.25205963,356262800
245.199997,247.600006,240.639999,246.720001,4789700,26026947.98,1.92434151,-16111932.84,259.98999,242.779999,31.42121358,18.8188675,19162166.49,-42.14034047,50.9270807,-4.360001,2.714406362,-7.194342182,361052500
247.350006,249.720001,246.089996,248.089996,3159800,33416522.74,1.829619756,-9072983.836,252.779999,242.779999,61.36735585,32.07056556,19188762.89,-37.78976748,51.95176999,-1.01001,2.546192361,-30.96652976,364212300
248.339996,249,246.600006,248.440002,1981200,8083854.812,1.762477895,-13428991.42,252.779999,242.779999,64.25043657,52.34633533,19193220.74,-49.80592701,52.22623121,-3.259995,-1.051457694,-75.07548309,366193500
245.350006,246.690002,242.520004,244.520004,2119700,6319463.744,1.377082261,-14551574.27,252.779999,242.779999,31.96050247,52.5260983,19161960.48,-66.70976573,48.85994083,-14.159989,-1.838619787,-63.89418819,364073800
241.160004,242.470001,229.009995,231.639999,8619400,18870178.43,0.031976084,-9694533.107,249.720001,231.639999,12.69919478,36.30337794,19050306.03,-91.51063775,39.78579424,-22.339997,-7.969804624,38.22001283,355454400
234.570007,234.880005,228,231.429993,5887000,32974139.24,-1.038999048,-2338616.636,249.720001,231.429993,15.79186391,20.15052039,19042491.64,-89.27791787,39.65647376,-26.270019,-10.5342511,-3.509203258,349567400
226.25,229.720001,225.5,229.300003,5307700,36881328.04,-2.036155415,2126419.871,249,229.300003,16.17022553,14.88709474,18988310.02,-88.98230182,38.2968073,-18.440002,-9.717297972,31.84539335,344259700
228.600006,230.899994,227.809998,228.279999,3855600,18184012.41,-2.875567071,-2189431.067,246.690002,228.279999,13.11938998,15.02715981,18964699.58,-91.93969323,37.6314149,-20.430008,-11.41638014,-13.8028169,340404100
228.669998,229.389999,222.259995,223.710007,6063600,2504821.059,-3.865013548,-8744800.874,242.470001,223.710007,7.174723253,12.15477959,18887513.4,-96.15687201,34.72068569,-19.069992,-9.699684151,-23.42489108,334340500
221.539993,224.860001,212.339996,214.360001,9225600,14860469.33,-5.342044587,-6700218.539,234.880005,214.360001,8.961864212,9.751992483,18634083.98,-95.76074448,29.66503306,-32.36,-13.81126816,157.1810883,325114900
209.339996,217.729996,204.270004,216.889999,9431500,129335528.3,-6.236561435,31169194.7,230.899994,214.360001,47.39016049,21.17558265,18742969.73,-73.98475304,32.52793142,-31.199997,-10.66397566,26.00366061,334546400
214.130005,216.770004,207.699997,209.839996,7314100,128500664.5,-7.428715199,43562025.75,230.899994,209.839996,20.91623767,25.75608746,18436399.1,-88.51784668,28.98718742,-38.600006,-14.94812129,52.7047623,327232300
210.529999,215.429993,208.229996,208.880005,6694400,8325157.242,-8.354661559,6433974.697,229.389999,208.880005,18.35191846,28.88610554,18402938.04,-90.49680174,28.53174966,-35.639999,-15.8047449,111.8615102,320537900
204.820007,211.679993,204.5,207,7173800,11519928.09,-9.1348802,-8323162.256,224.860001,207,13.25884603,17.50900072,18342685.71,-93.99340774,27.61664576,-24.639999,-16.68008439,262.0936806,313364100
209.289993,209.800003,202.669998,204.039993,5218300,16191958.96,-9.878187326,-12116966.43,217.729996,204.039993,9.096913559,13.56922602,18240103.6,-97.08821485,26.19224205,-27.39,-16.55488726,146.1810634,308145800
200.889999,203.679993,195.369995,197.809998,8426100,17541117.75,-10.84495818,-12138157.04,216.770004,197.809998,11.40187838,11.25254599,18080772.17,-95.45030249,23.45068469,-31.490005,-14.60455929,-2.242615495,299719700
193.059998,206.649994,192.649994,205.820007,7367800,111204925.8,-10.83983539,18758763.64,215.429993,197.809998,57.81393142,26.10424112,18421974.02,-75.62914313,33.14054435,-22.459992,-11.06597536,25.15372855,307087500
212.380005,218.440002,211.800003,218.259995,7483300,144736413,-9.719927207,40362180.43,218.440002,197.809998,99.30202813,56.17261265,18867291.97,-48.59494701,44.8223731,-5.450012,-4.814656719,40.98950581,314570800
220.190002,220.399994,214.5,219.289993,6910500,79940322.79,-8.649572781,24913714.92,220.399994,197.809998,95.9999964,84.37198532,18902606.66,-36.91690253,45.66881716,4.929992,-3.938148782,79.23280423,321481300
220,224.059998,218.259995,222.600006,4799400,51422464.33,-7.448358757,7255140.888,224.059998,197.809998,95.35182485,96.88461646,19006915.32,-21.69931503,48.4078478,5.710007,-0.496178519,-20.84900059,326280700
223.809998,224.320007,219.520004,220.970001,4505700,23009975.9,-6.552383966,-9668716.705,224.320007,205.820007,89.42215148,93.59132424,18971771.35,-25.96076601,47.14733065,11.130005,3.083597672,-51.1609001,321775000
219.770004,222.5,219.25,222.259995,1332200,7300180.134,-5.672832868,-20711710.13,224.320007,218.259995,83.54623529,89.44007054,18998075.04,-19.40664951,48.29482469,13.37999,2.475907614,-85.87499337,323107200
221.509995,228.5,221.5,227.820007,3327000,24615007.77,-4.475544494,-17837152.27,228.5,219.289993,95.14290714,89.37043131,19031401.09,-1.896772346,53.02842273,20.820007,8.568438497,-54.51251692,326434200
226.899994,227.910004,224.020004,225.710007,2802500,23854746.46,-3.654813779,-15281538.81,228.5,220.970001,72.75398791,83.81437678,19000587.43,-7.78240595,51.11590774,21.670014,8.05725852,-58.13665153,323631700
223.990005,225.649994,221.399994,222.229996,2903200,3224715.184,-3.247748555,-19410930.64,228.5,220.970001,32.21617297,66.70435601,18957378.31,-17.48954798,48.03861067,24.419998,7.35748599,-59.53051381,320728500
223.089996,225.679993,222.25,222.410004,2297500,-1749274.845,-2.877451817,-20918230.43,228.5,222.229996,34.16220541,46.37745543,18959729.92,-16.9874337,48.21228513,16.589997,9.00314234,-55.9722515,323026000
222.869995,223.25,213.259995,219.309998,4764400,25122865.73,-2.801835743,-11082969.21,228.5,219.309998,39.69816939,35.35884926,18927706.79,-25.63458985,45.39812662,1.050003,10.86901583,-43.45664068,318261600
214.550003,216.5,207.160004,210.089996,5368500,38990862.39,-3.446161363,-1639366.208,227.910004,210.089996,14.12044337,29.32693939,18727406.86,-51.3528617,38.24745901,-9.199997,2.074622901,-27.13564429,312893100
210.059998,214.199997,204.210007,211.279999,6261900,54486557.99,-3.816773374,7303407.818,225.679993,210.089996,32.92965352,28.91608876,18757815.41,-48.03346755,39.57045852,-11.320007,-3.19801895,-16.32167627,319155000
213.350006,214.779999,209.779999,210.949997,2968400,43640503.7,-4.089967863,6846851.935,225.679993,210.089996,31.39261479,26.14757056,18748034.83,-48.95397507,39.31888827,-10.020004,-3.803181297,-57.04507633,316186600
212.809998,213.800003,210.009995,210.619995,3442500,410720.2271,-4.283724755,-7717293.115,223.25,210.089996,33.66591574,32.66272801,18743391.18,-73.61058111,39.05151941,-11.64,-5.38185565,-28.27228404,312744100
208.919998,209.979996,204.960007,206.660004,4668300,4060188.827,-4.70260793,-11812585.8,216.5,206.660004,19.93489337,28.3311413,18678666.71,-89.91355411,35.89702105,-21.160003,-6.475990829,3.608762235,308075800
203.050003,204.470001,199.25,202.210007,5950300,19885448.54,-5.332187295,-7378751.461,214.779999,202.210007,19.0599304,24.2202465,18578144.49,-89.88031795,32.70036995,-23.5,-9.02096124,346.6521543,302125500
203.320007,207.610001,200.910004,204.25,4477300,27745583.34,-5.60194733,-2393162.571,214.779999,202.210007,32.19575223,23.730192,18638174.02,-82.90598291,35.53448782,-17.979996,-10.34588986,34.57469191,306602800
185.830002,195.199997,185,192.690002,11551900,98700295.38,-6.671623012,22440456.04,213.800003,192.690002,26.70139305,25.98569189,18384770.94,-82.32183448,28.26947027,-29.720002,-14.62939346,312.1998216,295050900
194.490005,195.75,190,191.869995,5216500,92226286.4,-7.499071777,28499710.25,209.979996,191.869995,27.50198599,28.79971043,18335610.95,-84.20690805,27.8347416,-27.440003,-13.66152254,79.68104161,289834400
190.699997,194.490005,189.649994,193.070007,3603200,17500678.45,-7.966170886,4611283.506,207.610001,191.869995,35.69220099,29.96519334,18368236.49,-81.1931805,29.54232389,-17.019989,-13.1918513,56.83133841,293437600
193.869995,194.119995,187.039993,191.929993,4503200,31893565.68,-8.33229044,-1000907.269,207.610001,191.869995,30.65012248,31.28143649,18346960.79,-82.96461605,28.8440607,-19.350006,-12.48461322,-5.482327261,288934400
189.550003,198.679993,189.509995,196.570007,4153000,48992346.51,-8.1540378,2234709.247,198.679993,191.869995,84.57611784,50.3061471,18455828.15,-71.55848331,35.52391437,-14.37999,-6.435332123,-22.64133371,293087400
197,203.240005,195.199997,201.619995,4116900,53965599.21,-7.51860962,4937613.75,203.240005,191.869995,89.99994568,68.40872867,18562520.93,-56.54903268,41.91501178,-9,-4.572133683,-34.2547789,297204300
200.289993,203.5,198.330002,201.289993,3438600,34309295.57,-6.961409815,-659804.9988,203.5,191.929993,86.57347473,87.04984608,18555782.58,-48.28573651,41.62465078,-5.370011,-4.579286152,15.84018326,293765700
201.830002,208.619995,201.050003,206.550003,3234500,25613620.23,-6.025923017,-5656481.639,208.619995,191.929993,90.40782295,88.99374778,18645638.37,-27.63598481,47.82844209,4.339996,-1.932386334,-6.042120552,297000200
204.419998,208.029999,203.300003,205.979996,2781000,23153047.28,-5.269790922,-7969260.602,208.619995,196.570007,86.18524856,87.72218208,18636712.26,-29.55004465,47.2425211,1.729996,-0.329046737,-40.42799306,294219200
206.110001,206.369995,198.419998,199.369995,3149600,6466638.567,-5.144618666,-13500231.08,208.619995,199.369995,31.07301506,69.22202886,18547468.58,-50.10418923,40.97397356,6.679993,-1.404486376,-47.06821505,291069600
201.070007,205.979996,196.5,205.199997,3548100,30795404.13,-4.522849717,-6794636.22,208.619995,199.369995,71.78218308,63.01348223,18639569.57,-19.13530731,47.58057318,13.330002,0.46511481,-20.75357917,294617700
203.960007,207.470001,203,203.600006,3007000,29777373.48,-4.111800966,-3757662.966,208.619995,199.369995,58.58093176,53.8120433,18611904.23,-21.2531332,46.05699902,10.529999,5.661946072,-73.96965001,291610700
203.970001,211.949997,203.300003,210.940002,4149200,30416259,-3.157369346,-1970377.336,211.949997,199.369995,93.46281426,74.60864303,18720309.77,-3.747662755,53.42500121,19.010009,9.93902512,-20.4600786,295759900
213.220001,220.369995,211.270004,218.360001,4826200,64367151.69,-1.781705116,9742466.944,220.369995,199.369995,91.57941173,81.20771925,18866261.5,-5.682765858,59.45412289,21.789994,13.09887247,33.94205151,300586100
218.289993,221.479996,216.800003,218.550003,3305400,36866784.27,-0.668444319,4898289.341,221.479996,203.600006,88.27064264,91.10428954,18870460.94,-8.507528295,59.59834749,16.930008,13.86964569,-26.59886303,303891500
219.880005,225.479996,219.639999,220.990005,3522900,5762454.62,0.40603019,-7425550.871,225.479996,203.600006,80.02672687,86.62559375,18907364.08,-11.68051678,61.49266507,19.700012,12.42305394,-15.1721647,307414400
222,223.399994,216.5,217.360001,3243900,1997579.422,0.953654854,-12989986.62,225.479996,210.940002,63.39045283,77.22927411,18849496.57,-21.12381469,57.19609734,10.809998,7.806768371,-21.20527581,304170500
215.380005,217.929993,211.990005,217.479996,3472400,18750555.6,1.381409906,-8754946.408,225.479996,217.360001,43.70158688,62.37292219,18851287.39,-22.24075557,57.30230199,11.5,8.043123634,0.982958181,307642900
217.550003,220.5,215,216.289993,5390500,21627903.04,1.605874053,-5311006.098,225.479996,216.289993,31.87539562,46.32247844,18832287.17,-30.35007696,55.82304615,16.919998,4.715560329,66.65636111,302252400
212.210007,214.740005,207.279999,212.800003,9769100,54212498.37,1.485031957,6948523.096,225.479996,212.800003,30.32969731,35.3022266,18745307.69,-43.7542952,51.6147539,7.600006,3.311004531,251.2801151,292483300
193.570007,203.089996,193.279999,202.880005,15649600,201286242.1,0.582092788,58128292.31,223.399994,202.880005,31.87253517,31.35920937,18289906.14,-70.18631399,41.93723116,-0.720001,1.760550779,396.8757938,276833700
202.899994,205.990005,200.910004,203.770004,6191000,164902005,-0.06097465,62204277.7,220.5,202.880005,38.53785678,33.58002975,18358558.19,-67.42234169,42.9703579,-7.169998,-0.696877691,74.48775401,283024700
205.699997,205.699997,201.5,204.350006,3979600,25063477.91,-0.517839581,13722715.13,220.5,202.880005,40.66865023,37.02634739,18376179.98,-65.62109307,43.67374019,-14.009995,0.368369341,32.34452943,287004300
204.169998,206.169998,202.600006,204.460007,2713600,13810245.39,-0.861105876,-10938744.91,214.740005,202.880005,52.09694722,43.76781808,18378322.19,-65.27947503,43.81527422,-14.089996,-3.071961192,-34.59944086,289717900
205,212.440002,203.75,211.710007,5154100,44341218.06,-0.541885955,-10318692.27,212.440002,202.880005,96.19000582,62.98520109,18474544.43,-42.76394498,52.31920151,-9.279998,-3.045426804,6.794165182,294872000
210.779999,217.600006,209.809998,217.110001,5982100,83886770.51,0.145159213,3455704.338,217.600006,203.770004,97.06408064,81.78367789,18606007.79,-25.99377571,57.48124613,-0.25,-0.658889032,80.97960912,300854100
215.660004,218.199997,206.330002,207.339996,8499800,44101241.38,-0.097585389,-3882502.166,218.199997,204.350006,34.97004221,76.07470956,18336811.77,-56.33540898,47.46818147,-10.14,-6.176754012,141.272815,292354300
207.289993,207.289993,201.699997,204.110001,6603600,12966277.4,-0.544321242,-16438120.44,218.199997,204.110001,14.60608485,48.88006923,18204399.74,-66.36645028,44.69612263,-12.179992,-6.095877778,103.5697771,285750700
204.940002,207.139999,202.580002,203.759995,3909500,13873445.67,-0.916045579,-19791490.7,218.199997,203.759995,12.48483636,20.68698781,18193075.94,-67.45342554,44.3935857,-9.040008,-6.308626656,12.5878355,281841200
204,211.089996,202.220001,207.190002,6472900,31039635.71,-0.923224538,-13902128,218.199997,203.759995,33.27275758,20.12122626,18258886.76,-53.81804346,48.10100492,4.309997,-4.207310229,20.07976997,288314100
206.899994,208.550003,202.800003,203.339996,3882100,27903071.48,-1.225450986,-11227011.16,218.199997,203.339996,9.939387879,18.56566061,18138607.29,-63.04189335,44.51352196,-0.430008,-4.445491949,-60.26143657,284432000
202.699997,203.339996,195.830002,197.330002,7922100,4122143.443,-1.927702557,-16678666.72,211.089996,197.330002,9.829623786,17.68058975,18023866.47,-85.12122391,39.55416638,-7.020004,-2.735608667,-49.37825887,276509900
196.809998,200.240005,195.320007,199.559998,4432300,23723672.76,-2.278040118,-11155796.78,211.089996,197.330002,26.88645503,15.55182223,18113392.91,-74.79935994,42.13047529,-4.900009,-2.06605777,-28.40736553,280942200
199.25,202.520004,197.210007,202.440002,4222000,40197740.22,-2.296816633,-2640528.813,211.089996,197.330002,45.14901691,27.28836524,18177358.84,-63.24236061,45.36898021,-9.270005,-0.934672838,6.091064429,285164200
202.850006,206.190002,200.149994,200.630005,4877000,19869027.15,-2.429740254,-5385188.912,208.550003,197.330002,40.13605144,37.39050779,18139610.33,-76.79195664,43.71329549,-16.479996,-1.873227951,79.72435142,280287200
199.210007,200.75,192.149994,193.880005,6712400,4102016.771,-3.044654883,-11035217.81,206.190002,193.880005,12.32200865,32.53569233,17975528.45,-93.35888368,38.12545207,-13.459991,-8.421898545,30.2341825,273574800
194.389999,194.490005,188.25,190.880005,6736700,20070622.72,-3.731044922,-7262471.575,206.190002,190.880005,14.66000394,22.37268801,17871664.2,-91.21868026,35.92730148,-13.229996,-12.08143148,12.61429933,266838100
188.460007,193.5,187.600006,190.320007,5579700,25989633.53,-4.27096807,-3175529.076,206.190002,190.320007,14.63153085,13.87118115,17851900.28,-91.11110523,35.51566646,-13.439988,-8.208734122,-34.354926,261258400
191.149994,196.179993,191.009995,193.740005,4974900,23403044.94,-4.372492427,-2037919.052,206.190002,190.320007,33.02851168,20.77334882,17952165.95,-79.93463789,40.03437316,-13.449997,-5.080591813,-24.66381973,266233300
193.75,194.449997,189.75,191.070007,4149300,13726762.82,-4.615196622,-4466084.805,200.75,190.320007,26.38785234,24.68263162,17883605.13,-88.66012412,37.8069567,-12.269989,-6.227909458,6.133776698,262084000
188.949997,191.75,187.320007,188.679993,5434300,6117722.503,-4.943411036,-7474475.913,196.179993,188.679993,15.34975337,24.92203913,17831703.29,-94.27855856,35.88242794,-8.650009,-8.93383311,-16.04535834,256649700
192,195.910004,189.800003,195.699997,5628800,36640993.81,-4.584223593,1686266.407,196.179993,188.679993,94.58242936,45.44001169,18033891.17,-64.74550325,44.7746934,-3.860001,-3.757253443,44.99368898,262278500
195.429993,198.710007,193.940002,194.729996,4894100,32799174.48,-4.327946063,4058148.803,198.710007,188.679993,65.05697103,58.32971792,18005991.62,-68.82628343,43.86934445,-7.710006,-1.317592851,-38.22218856,257384400
194.960007,200.880005,193.110001,200.710007,4820900,36316149.52,-3.600799587,5778579.224,200.880005,188.679993,98.74632725,86.12857588,18156285.73,-36.92886235,50.51275567,0.080002,0.576272305,8.767457076,262205300
202,204.589996,194.529999,195.649994,8475200,38493932.37,-3.393710939,6649997.192,204.589996,188.679993,48.23388712,70.6790618,18034748.11,-55.85591305,45.59524912,1.769989,-3.35408414,100.7389863,253730100
197.449997,198.990005,195.619995,198.080002,4269500,11310646.54,-2.998940438,-2247286.148,204.589996,194.729996,55.98379255,67.65466897,18140011.61,-42.97828378,48.20313232,7.199997,-1.270997825,-12.45642813,257999600
198.5,200.5,197.470001,199.630005,2631600,14278770.51,-2.531824389,-4738382.056,204.589996,194.729996,56.79448467,53.67072145,18173421.03,-34.76416925,49.85431232,9.309998,2.965751935,-60.79494667,260631200
201.580002,203.789993,199.75,201.720001,3649900,10248851.31,-1.970274248,-6608951.761,204.589996,195.649994,75.00003267,62.59276996,18200972.17,-23.68840585,52.07286621,7.979996,5.678958359,-45.82065403,264281100
198.270004,198.589996,192.699997,194.300003,5730400,10315114.25,-2.099768717,-6752287.36,204.589996,194.300003,13.45673789,48.41708507,18066715.52,-59.58308949,44.53897085,3.229996,2.091212617,2.700862054,258550700
193.919998,194.789993,189.699997,190.410004,4128000,4373652.066,-2.487608819,-8087545.587,203.789993,190.410004,5.039085888,31.16528548,17951989.58,-82.10770719,41.17557375,1.730011,-1.718798861,-17.02345776,254422700
189.070007,189.289993,181.399994,185,8604900,25677715.21,-3.194690599,-1119990.628,203.789993,185,16.07863404,11.52481927,17834703.22,-84.47604274,36.99173058,-10.699997,-3.176849729,107.381968,245817800
185.850006,192.25,181.800003,190.570007,10089500,113161906.4,-3.267934278,29668069.12,203.789993,185,40.95584372,20.69118788,18093780.81,-60.45704093,43.37161422,-4.159989,1.00170345,85.6632869,255907300
193.529999,193.759995,188.410004,188.770004,5026600,83984132.71,-3.431667493,30282250.18,198.589996,185,42.873817,33.30276492,17998481.81,-68.21901956,41.89528726,-11.940003,-3.541130867,-10.69855031,250880700
188.699997,192.300003,186.050003,187.589996,3794600,105257.7015,-3.614972873,1091841.285,194.789993,185,46.22854714,43.35273596,17967060.36,-73.30745379,40.91212454,-8.059998,-3.666615389,-22.4658262,247086100
190.229996,193.229996,190,191,5010400,4535251.979,-3.445368815,-9539404.294,193.759995,185,77.66994517,55.59076977,18036038.46,-58.60282375,44.93373904,-7.080002,-4.837829038,3.930801303,252096500
198,207.75,197.5,203.100006,12455800,65653091.38,-2.307982037,6425253.623,207.75,187.589996,82.08094591,68.65981274,18353451.39,-17.64703203,56.29961075,3.470001,3.807826337,46.96762318,264552300
202.509995,205.059998,201.139999,203.25,4347900,71268380.8,-1.378599917,14158819.08,207.75,187.589996,79.26266994,79.67118701,18362650.28,-17.07779497,56.41969345,1.529999,2.610055507,1.836280595,268900200
208.199997,210.899994,205.869995,207.669998,6303100,14464584.4,-0.282148559,-2038550.19,210.899994,187.589996,87.00202346,82.78187977,18457202.36,-10.94913898,59.91518217,13.369995,4.027447177,139.5158839,275203300
208.429993,210.369995,206.119995,210.089996,3800200,22134518.2,0.773158169,-6038990.483,210.899994,191,96.12441037,87.46303459,18530652.97,-2.745755932,61.72530075,19.679992,4.149313384,4.117921039,279003500
209.850006,211.649994,209,210.899994,4067700,21413799.71,1.655769741,-7355854.622,211.649994,203.100006,94.6996444,92.60869274,18545304.57,-2.479338843,62.33832877,25.899994,8.543484685,-29.0154265,283071200
210.440002,213,209.050003,209.779999,3758200,6257188.245,2.239061032,-12048415.91,213,203.25,72.84990954,87.89132144,18523702.85,-10.18987465,60.88620295,19.209992,10.1727822,-8.958333333,279313000
208.570007,209.490005,205.5,207.460007,3026000,4071261.875,2.485468681,-13568311.56,213,207.460007,26.13342667,64.56099353,18482140.29,-17.53162009,57.87858883,18.690003,12.14054432,-64.83398994,276287000
207.460007,209.589996,206.600006,207.830002,1952400,5643646.237,2.679713949,-12456300.07,213,207.460007,31.06669333,43.35000985,18487537.01,-16.36075006,58.23293782,20.240006,9.057036452,-80.64918975,278239400
207.699997,209.169998,206.289993,206.699997,1659100,509536.3188,2.711219512,-12502575.79,213,206.699997,15.99996,24.40002667,18476921.5,-19.93671457,56.66505782,15.699997,9.498327393,-66.99359408,276580300
204.990005,206.880005,203.5,206.789993,2469900,7317509.321,2.712185438,-9218735.742,213,206.699997,34.63150526,27.23271953,18477643.86,-19.9038705,56.76489864,3.689987,10.23508578,-34.91013546,279050200
206.779999,207.850006,203.850006,205.270004,2559300,10043629.57,2.560781437,-6169877.846,209.589996,205.270004,29.06412418,26.56519648,18459489.11,-28.68273418,54.48180706,2.020004,7.471206283,-48.92024589,276490900
205.800003,210.75,204.309998,209.410004,3432500,18775008.21,2.743233785,-1583553.881,210.75,205.270004,81.51729655,48.40430866,18511106.5,-13.32095139,59.28512318,1.740006,3.106842843,-72.44255688,279923400
212.5,221.880005,211.690002,219.440002,7863000,75847006.53,3.655032658,18595901.19,221.880005,205.270004,86.72468805,65.76870293,18675511.1,-7.65370959,68.07483277,9.350006,7.96556064,80.84592562,287786400
218.270004,221.479996,217.149994,218.600006,4411200,62517745.58,4.260743973,20919467.86,221.880005,205.270004,82.15452607,83.46550356,18645412.27,-13.45364367,66.77468033,7.700012,5.263161798,-30.01538925,283375200
220.5,220.800003,218.009995,218.429993,2427800,2419639.788,4.673186343,846123.4841,221.880005,205.270004,80.86515701,83.24812371,18641981.52,-16.63457571,66.49785557,8.649994,3.969725907,-36.11388874,280947400
222.559998,238.75,222,231.550003,11672600,105413234.9,5.989679751,25328069.83,238.75,209.410004,79.09408658,80.70458989,18787807.47,-20.4255234,75.08267618,24.089996,9.791374864,186.9582319,292620000
234.75,235.5,228.029999,230.479996,6085400,117275581.2,6.867505313,36815242.61,238.75,218.429993,69.43826825,76.46583728,18733867.65,-23.46100426,73.4300688,22.649994,9.867478834,61.92326114,286534600
230.050003,234.970001,227.630005,232.449997,3936100,28440298.94,7.634149291,9901928.709,238.75,218.429993,70.83332755,73.12189413,18785881.9,-17.87234894,74.54111921,25.75,12.04569033,30.07600793,290470700
230.389999,232.889999,225.169998,226.050003,3911900,17597119.14,7.637256598,-5458341.34,238.75,218.429993,38.76569943,59.67909841,18677510.14,-36.02836028,65.02764464,19.26001,8.766780939,100.363655,286558800
229.940002,231.770004,220.410004,226.029999,5281700,26990889.06,7.551061074,-8256948.537,238.75,226.029999,30.64338182,46.7474696,18677163.96,-36.08510922,64.9997207,20.759995,9.351718568,218.3472967,281277100
228.179993,234.729996,227.110001,230.509995,4434600,39636083.08,7.754855588,-4627730.791,235.5,226.029999,66.93170098,45.44692741,18781849.16,-23.37590071,68.28442812,21.099991,11.47057537,79.5457306,285711700
237.759995,239.5,229.130005,232.949997,5796900,31104318.08,8.020793267,-5437000.504,239.5,226.029999,65.68881942,54.42130074,18828790.43,-18.19445278,69.93914519,13.509995,13.48467504,126.5033408,291508600
234.100006,234.470001,228.199997,230.429993,5270900,26840453.54,7.936717986,-6630476.785,239.5,226.029999,52.4881671,61.70289583,18766080.79,-25.19446389,66.10322486,11.829987,10.03771959,53.55863074,286237700
221,237.479996,220.25,236.800003,9455900,164479829.7,8.288549057,37278400.49,239.5,226.029999,85.97404156,68.05034269,18911789.62,-7.573625398,70.5067057,18.37001,7.911046683,20.25817118,295693600
235.990005,238.410004,233.699997,236.610001,4668200,167922445,8.454586927,52947555.11,239.5,230.429993,84.98701818,74.48307561,18904202.46,-8.212557078,70.21370923,5.059998,8.238789801,5.826079071,291025400
236.289993,242.880005,235.309998,239.490005,5672300,32970539.59,8.718068916,11605007.09,242.880005,230.429993,85.01988842,85.32698272,18961023.54,-10.86886718,72.10589591,9.010009,9.641538559,133.639509,296697700
240.110001,246.350006,238.190002,244.740005,6363400,61594849.87,9.243952881,2744880.981,246.350006,230.429993,93.83141521,87.94610727,19085369.33,-5.513699789,75.19882973,12.290008,5.696394657,-45.48429656,303061100
247.610001,248.300003,242.25,243.179993,5440200,40880168.51,9.426180638,-7720285.678,248.300003,236.610001,81.74684687,86.86605017,19044808,-16.90329696,72.62203431,17.12999,5.510238294,-10.60242548,297620900
244.820007,244.889999,241.25,244.100006,2895900,8080235.361,9.534922161,-21735988.43,248.300003,236.610001,71.23290908,82.27039039,19065389.69,-14.97324974,73.20517125,18.070007,5.011834438,-26.42717411,300516800
243.929993,249.399994,242.5,248.839996,4527600,35962341.49,9.88957729,-16622106.84,249.399994,239.490005,96.0255631,83.00177302,19121622.94,-1.921091305,76.03706836,18.330001,10.08183707,15.73915489,305044400
247,249.899994,246,248.75,3353200,36570049.03,10.04756009,-12825602.26,249.899994,243.179993,90.17937843,85.81261687,19119985.48,-3.878564023,75.87310575,15.800003,10.05176353,-36.51286518,301691200
248.429993,251,246.149994,247.139999,3674200,8945810.106,9.928400553,-18896053.48,251,243.179993,60.41024615,82.20506256,19098282.34,-12.55284878,72.84676826,16.710006,7.214439443,-17.14698056,298017000
247.130005,247.740005,241.369995,244.350006,3755600,9906340.502,9.49933423,-19355973.53,251,244.100006,31.79493333,60.79485264,19056803.86,-21.62599675,67.79991911,7.550003,4.893757951,-35.21364867,294261400
243.029999,246.619995,242.360001,245.619995,1970600,15154631.3,9.1562263,-16114577.98,251,244.350006,44.13289505,45.44602485,19076323.28,-17.49595122,68.85757405,9.009994,6.592024676,-62.6135954,296232000
245.380005,248.600006,245.009995,247.729996,2223100,11469645.36,8.951384254,-14496086.42,251,244.350006,66.0435898,47.32380606,19093251.74,-10.63415935,70.58621704,8.239991,4.615706445,-76.48981059,298455100
247.679993,252,246.5,247.460007,3498700,5978847.125,8.66734781,-14263222.36,252,244.350006,57.29077268,55.82241918,19090828.89,-14.29919055,70.05040605,2.720002,4.58560752,-25.05248276,294956400
248.509995,249.5,245.550003,247.429993,3408200,5092068.28,8.343644662,-13153460.12,252,244.350006,57.00842097,60.11426115,19090404.54,-14.39372283,69.98680411,4.25,3.315373433,-39.91502565,291548200
247.029999,251.800003,245.050003,251.449997,3647300,27774880.77,8.315630894,-4286438.854,252,245.619995,94.2945741,69.53125592,19145777.69,-3.005480382,73.462254,7.349991,2.741681729,-42.6831568,295195500
251,252.869995,249.429993,250.800003,3789300,26064775.4,8.147066387,-813469.2394,252.869995,247.429993,73.66422392,74.989073,19136349.48,-11.78811135,72.01027347,1.960007,3.133485574,-30.3463108,291406200
251.410004,251.600006,247.470001,249.449997,2505100,6567176.138,7.814463331,-5522538.777,252.869995,247.429993,56.26596549,74.74158784,19115952.44,-23.29700021,68.96157312,0.699997,2.191720962,-13.49494112,288901100
248.919998,249.399994,246.300003,248.350006,2134800,7309251.501,7.377074608,-6710812.448,252.869995,247.429993,42.19957003,57.37658648,19104905.78,-38.89837302,66.4914193,1.210007,-0.196909664,-52.84919162,286766300
248.199997,250.720001,247.009995,248.990005,1781500,6349939.814,7.00137596,-6892086.082,252.869995,248.350006,50.38370883,49.61641478,19110407.17,-33.39063399,67.22696282,4.639999,0.096484422,-46.871645,288547800
247.5,249.300003,245.710007,245.919998,2453600,901817.9388,6.382336564,-8073183.521,252.869995,245.919998,2.932840111,31.83870632,19088441.56,-60.43475652,60.38010993,0.300003,-0.493647732,-33.22083719,286094200
246,249.699997,245.679993,249.139999,3022000,8240318.205,6.081467185,-5487456.614,251.600006,245.919998,58.44591895,37.25415597,19120568.25,-32.43474783,64.46774064,1.410003,1.960299931,-19.53349665,289116200
250.850006,258.75,250.309998,256.290009,5017000,38574584.87,6.346810011,5721012.568,258.75,245.919998,81.17834979,47.51903628,19207295.91,-14.15414437,71.49926874,8.830002,4.344114574,154.5925099,294133200
255.399994,257.73999,254.139999,256,2611100,32134040.98,6.459236749,7736939.4,258.75,245.919998,78.95946039,72.86124304,19201618.85,-15.82278026,70.88652331,8.570007,3.33831354,17.45310602,291522100
251.899994,254,248.5,250.699997,3454500,9121808.795,6.050918578,536204.7361,258.75,245.919998,38.40857928,66.18212982,19147560.89,-49.11533552,60.65592501,-0.75,1.309298435,-1.263326378,288067600
253.259995,254.369995,250.429993,251.410004,2044100,5994764.651,5.718693578,-3453264.83,258.75,249.139999,43.84091761,53.73631909,19157344.37,-53.42062103,61.45841229,0.610001,1.608540239,-40.02405962,290111700
250.210007,253.460007,250.210007,250.690002,1422300,-61965.63207,5.335796981,-6698528.849,258.75,250.690002,21.36587317,34.53845668,19151490.36,-58.83211507,60.11926534,1.240005,-0.302244983,-61.00403038,288689400
249.699997,251.279999,246.009995,250.380005,2186200,8650821.265,4.950270861,-4644929.312,257.73999,250.380005,37.25500309,34.15393129,19149731.58,-61.09486739,59.51794855,2.029999,-0.167463315,-42.3059668,286503200
250.130005,253.440002,249.100006,253.119995,1984700,17012495.3,4.81038184,-722021.4617,254.369995,250.380005,85.04784689,47.88957438,19173655.88,-41.09493601,63.03705495,4.12999,1.471235937,-20.77362181,288487900
252.169998,264.359985,252.020004,260.410004,5512900,52320704.18,5.227502192,12182872.89,264.359985,250.380005,78.47420625,66.92568541,19230816.44,-21.14551762,70.40779347,14.490006,4.856049007,158.2396477,294000800
262,263.459991,260.019989,261.890015,2782700,48422302.84,5.612796769,15114213.52,264.359985,250.380005,86.53966569,83.35390628,19262148.39,-13.22254314,71.64405438,12.750016,5.180934873,56.1998316,296783500
262.399994,263.799988,260.100006,262.51001,2463000,9010858.863,5.900160533,2399374.018,264.359985,250.380005,89.91838688,84.97741961,19268736.12,-9.903510665,72.16859111,6.220001,6.746101226,0.383110531,299246500
262.149994,264.399994,255.690002,259.790009,4561100,21363592.34,5.84108465,910139.0512,264.399994,253.119995,69.86935545,82.10913601,19243215.71,-24.62598693,66.36819888,3.790009,4.274709016,50.92984778,294685400
260.320007,268,258.570007,267.670013,3870800,51375314.62,6.356839367,9767351.015,268,259.790009,97.93499948,85.9075806,19381563.93,-1.478435916,73.11081993,16.970016,4.440283897,-22.8463225,298556200
266.980011,267.350006,263.720001,265.170013,2412300,37138012.49,6.489047885,7972764.228,268,259.790009,77.01066239,81.60500578,19345411.21,-12.67914925,68.42392858,13.760009,3.582036328,-7.61364942,296143900
266.450012,271.410004,265.25,268.790009,2849200,10923523.18,6.807455403,-1827155.53,271.410004,259.790009,83.33336726,86.09300971,19378342.97,-10.31493729,71.29361536,18.100007,7.215800645,-17.52207266,298993100
268.890015,269.109985,266,267.089996,3838400,10565095.19,6.84372857,-5784153.833,271.410004,259.790009,72.51903658,77.62102208,19360322.67,-17.00789949,68.16076472,16.709991,6.23682103,87.77946284,295154700
261.950012,265.950012,260.700012,262.019989,3478900,3678581.118,6.389711507,-9068257.27,271.410004,262.019989,26.86902497,60.90714293,19287460.66,-36.96854989,59.73075534,8.899994,4.519520886,144.5967799,291675800
264.799988,270.920013,264,268.26001,3086900,13951490.41,6.458962361,-6318714.148,271.410004,262.019989,70.58826935,56.65877696,19370310.86,-12.40154679,65.40231853,7.850006,7.141147313,41.19934132,294762700
271.109985,272.619995,267.850006,269.149994,2101200,13166627.72,6.510608193,-4869201.532,272.619995,262.019989,70.88921184,56.11550205,19380552.01,-13.04021421,66.13491082,7.259979,6.332964332,5.869904772,296863900
280.200012,282.450012,273.309998,280.019989,7163900,47368048.83,7.343998596,7048705.939,282.450012,262.019989,88.82748046,76.76832055,19465411.88,-6.668556165,73.51215031,17.509979,7.530426903,29.94794029,304027800
278.880005,281.690002,276.299988,279.720001,4121900,58755498.62,7.889316836,14906701.57,282.450012,262.019989,87.44822529,82.38830586,19457737.13,-8.185938557,73.03926343,19.929992,6.808196181,48.12592087,299905900
275,275.200012,260.769989,267.880005,6105100,52900821.55,7.282152621,14903329.66,282.450012,267.880005,32.79524196,69.6903159,19283265.23,-47.88039162,57.35676809,0.209992,2.045634374,147.8725132,293800800
259.320007,260.799988,254.309998,254.960007,6221100,38756136,5.692811557,9046520.329,282.450012,254.960007,2.309910009,40.85112575,18988812.95,-97.69008999,45.80035196,-10.210006,-1.85919467,36.39472934,287579700
259.079987,262.950012,256.790009,257.920013,3334100,-509190.1524,4.618851811,-6665370.93,282.450012,254.960007,12.8287605,15.97797082,19061037.97,-87.1712395,48.3670809,-10.869996,-3.642544748,-13.86535083,290913800
262.220001,263,257.820007,259.149994,2610900,2576984.331,3.822912012,-11505055.39,281.690002,254.960007,17.6771194,10.93859664,19076937.78,-82.80030706,49.43858359,-7.940002,-2.270248786,8.232806865,293524700
262.25,262.549988,256.049988,262.160004,2960300,19441793.28,3.395861264,-7072936.603,275.200012,254.960007,37.57779195,22.69455729,19107263.21,-72.10375944,52.06047405,0.140015,-2.466611398,3.899340166,296485000
262.100006,265.98999,260.51001,265.649994,1907600,27596549.35,3.300981831,-2022107.751,265.98999,254.960007,97.08907335,50.78132824,19146672.04,-59.7015268,54.97576926,-2.610016,-0.539144866,-50.30220925,298392600
266.73999,267.48999,262.079987,263.140015,2021600,10204141.62,2.988801821,-5305979.52,267.48999,257.920013,61.97574965,65.54753832,19128648.19,-68.62113501,52.50289168,-6.009979,0.427458227,-41.88967777,296371000
264.220001,267.200012,263.160004,266.679993,1616000,5997756.96,2.992547332,-7505414.952,267.48999,259.149994,92.91960788,83.99481029,19155844.43,-56.0412621,55.54036423,-13.339996,-0.588987155,-47.6497457,297987000
272.5,275.540009,268.25,274.660004,5004100,36952531.91,3.597960819,2126373.034,275.540009,262.160004,95.48484324,83.46006693,19204200.88,-27.68302816,61.51515311,-5.059997,2.047189345,138.154388,302991100
275,286.649994,272.540009,282.26001,4978500,78314320.78,4.637553507,19033912.48,286.649994,263.140015,83.20586577,90.5367723,19342667.31,-13.57447292,66.17705577,14.380005,0.799950392,-30.50573012,307969600
270.049988,273.5,266.549988,266.769989,6108700,42270673.48,4.1635284,12751844.25,286.649994,263.140015,19.08832179,65.9263436,19069454.43,-61.47188454,52.27724506,11.809982,-4.629633903,48.20107232,301860900
261.269989,269.440002,260.859985,267.869995,3105000,16626504.88,3.832443357,863140.4928,286.649994,266.679993,27.18110723,43.1584316,19094643.2,-58.07050502,53.03170121,9.949982,-0.003736748,-49.14088221,304965900
269.649994,269.899994,265.269989,267.200012,2227200,24197673.46,3.475925738,-1669879.271,286.649994,266.769989,24.58326788,23.61756563,19086877.13,-60.14219049,52.4874277,8.050018,4.800754889,-64.19925737,302738700
267.380005,271.089996,263.920013,265.410004,2836500,4979069.434,3.014198467,-8669317.793,286.649994,265.410004,17.64256461,23.13564657,19071956.82,-65.67715716,50.98195125,3.25,2.903997605,-14.92456735,299902200
262.429993,264.429993,250.789993,253.009995,4694200,8470257.384,1.628921984,-9633772.133,273.5,253.009995,9.77543512,17.33375587,18939434.97,-93.80925282,41.99575697,-12.639999,-2.369283867,79.79240875,295208000
255.75,265.399994,251.839996,264.820007,3895800,56891842.15,1.467137412,6254343.712,271.089996,253.009995,69.11335924,32.17711966,19158551.05,-60.87558949,50.87671424,1.679992,1.014648672,31.60152687,299103800
264.269989,267.890015,262,263.820007,2790100,53550934.86,1.243891524,11122434.81,271.089996,253.009995,64.1872516,47.69201532,19143839.92,-63.66421183,50.17617588,-2.859986,-0.688871463,46.26231914,296313700
262.690002,266.940002,262.109985,266.790009,2034600,12608832.48,1.291731611,-924236.3905,271.089996,253.009995,78.81780116,70.70613733,19175249.99,-55.3819979,52.27789132,-7.869995,1.387091963,0.643055006,298348300
267.600006,269.359985,265.119995,266.149994,2222600,10065394.25,1.263437245,-6577674.374,269.359985,253.009995,82.71409595,75.23971623,19170369.09,-57.16675803,51.77108477,-16.110016,-0.198739693,37.53712871,296125700
266.290009,266.709991,257.070007,259.98999,2553500,6282740.759,0.735474818,-9496045.626,269.359985,259.98999,46.5182598,69.3500523,19118927.33,-74.34468281,47.04389585,-6.779999,-5.341154076,-48.97184309,293572200
260.01001,266.720001,258.339996,266.279999,2352500,24231476.46,0.815214663,-4115686.54,269.359985,259.98999,74.93904383,68.05713319,19180704.85,-56.80422318,51.87596039,-1.589996,-5.661450589,-52.74681129,295924700
263.579987,271,260.399994,270.130005,6214300,78510505.26,1.17552169,15730122.84,271,259.98999,93.75451947,71.73727437,19214718.44,-46.06801043,54.60624328,2.929993,1.259517989,1.728682044,302139000
249.539993,255,236.119995,246.130005,14623800,199469161.3,-0.470112652,60905697,271,246.130005,28.69841905,65.79732745,18662602.06,-80.18996596,39.54472758,-19.279999,-8.115873523,370.9758454,287515200
243.580002,243.729996,238.389999,242.509995,5073400,159257287.1,-2.042845625,61055044.89,271,242.509995,18.3199515,46.92429668,18447519.38,-82.90529924,37.84897042,-10.5,-9.240275408,127.7927443,282441800
238.149994,242.970001,236.050003,241.139999,4185900,39942542.56,-3.361050962,17601900.78,271,241.139999,14.56365218,20.52734091,18418858.55,-85.47375281,37.19884265,-23.680008,-9.144344461,47.57271285,278255900
237.149994,239.300003,234.440002,237.369995,4264900,31001694.04,-4.656271405,-4619373.689,271,237.369995,8.014204487,13.63260272,18353415.82,-92.00547482,35.39699435,-26.450012,-6.181573973,-9.145328277,273991000
235,239.770004,232.740005,238.169998,3728000,30196978.84,-5.554164432,-13545997.74,255,237.369995,24.39350503,15.65712057,18367789.72,-85.84095365,36.10428033,-28.620011,-10.06344245,-4.307202628,277719000
239.860001,246.479996,239.119995,242.509995,4689200,32761555.68,-5.848135967,-15150342.43,246.479996,237.369995,71.10623289,34.50464747,18435722.33,-74.46421517,39.94551027,-23.639999,-8.077481402,68.06566073,282408200
247.240005,247.929993,241.770004,243.149994,4364800,16003426.62,-5.960756069,-19761493.37,247.929993,237.369995,68.53191062,54.67721618,18448097.42,-72.79145227,40.51343656,-16.839996,-8.860907156,114.5286543,286773000
255.559998,256.589996,250.509995,254.990005,7176700,32899497.02,-5.036560047,-14475351.51,256.589996,237.369995,93.29143982,77.64319444,18660638.16,-41.84526161,49.94441081,-11.289994,-4.19312014,222.8966076,293949700
255.380005,260.950012,253.559998,260.720001,4195000,60168738.46,-3.79798445,-2320321.058,260.950012,238.169998,99.18464749,87.00266598,18821909.04,-26.86879337,53.76471638,-9.410004,0.280784272,64.28431565,298144700
260.329987,260.649994,255.020004,255.25,3604300,27277562.24,-3.220661946,-7602244.575,260.950012,242.509995,73.88910874,88.78839868,18733896.4,-41.16571369,49.85310662,9.119995,-4.142255912,53.21147715,294540400
252.059998,254.559998,241.899994,242.179993,4905800,-6051763,-3.774262686,-19676703.63,260.950012,242.179993,2.137585136,58.40378046,18549339.2,-75.32674011,41.99178453,-0.330002,-10.34687428,-21.05627343,289634600
236,243.800003,230.509995,230.770004,6590200,-8171436.609,-5.075182471,-23501905.42,260.950012,230.770004,0.85416838,25.62695409,18318208.94,-99.35784399,36.57021571,-10.369995,-6.240604838,-54.93510579,283044400
202.789993,231.399994,195,218.869995,9581600,220666705.9,-6.985873249,49881912.4,260.950012,218.869995,36.19407226,13.06194193,17978375.18,-68.59211184,31.93868617,-18.5,-9.748051828,88.85954192,273462800
230.520004,230.899994,219.119995,220.029999,4327300,225359306.2,-8.310706181,76860945.93,260.649994,218.869995,38.12642999,25.05822354,18029157.35,-62.04701373,32.83169994,-18.139999,-8.754250679,3.378007119,277790100
227.929993,228,215.509995,224.839996,4963000,44993986.85,-8.870268333,23521499.32,254.559998,218.869995,50.10073372,41.47374532,18123754.91,-54.75361551,36.54931276,-17.669999,-5.278678546,16.36849633,282753100
231,244.75,230.809998,242.990005,7656000,137332668.2,-7.759722084,28942988.03,244.75,218.869995,96.46232161,61.56316177,18524388.68,-27.23275774,48.19988478,-0.159989,2.023767494,105.3648069,290409100
241.860001,251.449997,241.570007,248.479996,5513700,128725671,-6.36325811,25791099.02,251.449997,218.869995,94.73870477,80.43392003,18697364.4,-18.90828466,51.12331119,-6.510009,2.461754618,17.58295658,295922800
245.619995,254.949997,245.509995,249.059998,4700200,50195224.96,-5.150378676,-2829915.595,254.949997,220.029999,85.06592621,92.0889842,18710234.47,-18.02882765,51.43514705,-11.660003,2.430600101,7.68420088,300623000
240.339996,246,236.970001,238.630005,5454800,18356036.6,-4.973445471,-24411898.27,254.949997,224.839996,58.62071204,79.47511434,18513402.17,-33.84382553,45.77889448,-16.619995,-6.415937754,-23.99292154,295168200
245.300003,247.880005,239.779999,247.690002,4629200,41111355.43,-4.055410345,-23781298.98,254.949997,238.630005,69.92545443,71.20403089,18720503,-20.10615252,50.8364511,5.510009,-4.997698278,10.35041716,299797400
252.059998,252.080002,245,245.570007,4194800,35042384.45,-3.459052963,-23292426.5,254.949997,238.630005,47.83096726,58.79237791,18680881.37,-23.32070084,49.66897224,14.800003,-3.792357689,16.38320894,295602600
240.889999,244.089996,238.199997,241.929993,3689200,10941770.05,-3.242773476,-28643317.2,254.949997,238.630005,27.58616854,48.44753008,18618703.05,-28.84005389,47.64571748,23.059998,-0.103229006,-24.79921725,291913400
245.050003,249.160004,244.050003,248.169998,3138200,24729160.56,-2.538590875,-23841483.03,252.080002,238.630005,74.12307253,49.84673611,18713857.13,-19.00989663,51.30751169,28.139999,7.539972136,-52.38080787,295051600
252.050003,254.25,248.300003,248.910004,3390800,11346597.25,-1.898919232,-23967777.11,254.25,241.929993,66.7290031,56.14608139,18723214.78,-10.07505138,51.73861021,24.070008,13.72504669,-64.6113384,298442400
247.229996,250.720001,245.330002,248.479996,2709000,6432733.214,-1.410414518,-23404056.23,254.25,241.929993,64.04982603,68.30063389,18717356.95,-10.79232915,51.45353742,5.489991,12.93005369,-37.39745338,295733400
247.639999,250.240005,244.729996,250.240005,2350800,20360442,-0.871210226,-16614257.96,254.25,241.929993,75.01561215,68.59814709,18736545.08,-7.856534171,52.6046034,1.760009,11.29692646,-52.63348781,298084200
251.100006,254.25,249.669998,253.190002,2890900,22459837.35,-0.203501003,-11658236.7,254.25,248.169998,89.60785969,76.22443262,18764257.88,-4.462461741,54.54982704,4.130004,4.197702288,-62.24007315,300975100
252.75,254.600006,249.5,253.570007,2933500,20853823.04,0.352265892,-9081938.31,254.600006,248.479996,89.56435708,84.7292763,18768596.74,-3.498960269,54.80713644,14.940002,2.048459064,-46.79616229,303908600
253.039993,262.880005,252.880005,262.25,4417100,52456840.25,1.476102464,2853138.173,262.880005,248.479996,96.52889979,91.90037219,18869013.82,-1.964467922,60.33148204,14.559998,5.295913477,-6.023147951,308325700
263.959991,265.5,260.690002,262.070007,3585800,43501325.71,2.325421106,4626811.364,265.5,250.240005,83.48583371,89.85969686,18865982.19,-12.02240841,60.16723711,16.5,9.822738762,-34.26340104,304739900
257.959991,263.820007,257.5,260.619995,3763100,12226881.37,2.848670696,-5019173.837,265.5,253.190002,69.49996875,83.17156742,18846142.25,-17.10482009,58.77897756,18.690002,5.220232103,-18.70949624,300976800
263.980011,271.570007,255.800003,264.200012,6120200,58384985.83,3.511745997,6177699.443,271.570007,253.570007,66.60628608,73.19736284,18897834.22,-21.30055989,61.16167691,16.030014,7.586433387,45.89968532,307097000
259.029999,262.649994,255.869995,260.940002,3664400,66203835.53,3.731171762,12684445.28,271.570007,260.619995,43.12464493,59.74363325,18822316.01,-31.85496498,57.88070276,12.029998,7.857648721,-0.672232462,303432600
261.950012,262.079987,257.579987,261.059998,2600800,26115635.06,3.87013839,1437827.952,271.570007,260.619995,33.35443035,47.69512045,18824001.12,-31.49537264,57.97007744,12.580002,5.19402027,-17.12446625,306033400
259.529999,263.450012,256.209991,263.119995,3448200,32131203.11,4.099241482,-1379728.207,271.570007,260.619995,46.41718544,40.96542024,18844523.76,-25.32217401,59.55666795,12.87999,5.708887056,1.692815855,309481600
266.609985,266.910004,256.149994,256.910004,3773400,23030846.48,3.736639306,-5302502.999,271.570007,256.910004,7.038685596,28.93676713,18763141.53,-53.270352,53.05477514,3.720002,3.392630447,39.29125138,305708200
257.350006,259.790009,246.610001,248.429993,4901100,4056590.232,2.733498384,-12462492.13,266.910004,248.429993,8.965476508,20.80711585,18638590.24,-86.21462189,45.71535663,-5.140014,-0.723310408,108.4864727,300807100
250.460007,254.729996,245.460007,246.649994,3703200,5874581.61,1.774416564,-13680172.96,266.910004,246.649994,5.547725718,7.183962607,18603473.89,-92.84650815,44.32912947,-15.600006,-2.583043544,28.09851603,297103900
252,252.399994,242.339996,248.399994,4929600,29092225.28,1.142379051,-5547230.957,266.910004,246.649994,24.66420849,13.05913691,18629748.37,-79.26789011,46.06085602,-13.670013,-2.038889797,68.04499744,302033500
247.509995,248.5,237.130005,239.880005,4573000,37022083.33,-0.045482841,807312.0578,266.910004,239.880005,9.234385804,13.14877334,18460665.69,-92.01509919,39.60201933,-20.73999,-8.530026692,3.529465034,297460500
235.600006,247.699997,234.929993,247.570007,4424000,64983185.71,-0.362178092,12230220.23,259.790009,239.880005,50.84475408,28.24778279,18607265.56,-65.50215838,46.84677907,-16.630005,-5.532872749,23.37553684,301884500
248.839996,249.839996,244.130005,246.149994,3689900,60943399.64,-0.719451156,14506003.43,254.729996,239.880005,56.66666313,38.91526767,18581890.37,-69.37773823,45.75535372,-14.790008,-5.552145375,-1.945204751,298194600
240,243.029999,235.580002,241.460007,5225200,34692068.79,-1.365297094,5765581.891,252.399994,239.880005,37.37844091,48.29661937,18511585.34,-82.1779162,42.25392448,-19.599991,-8.607117323,-14.62370511,292969400
236.630005,237.699997,229.119995,231.960007,6814000,44416358.42,-2.613577562,4759903.242,249.839996,231.960007,13.70662096,35.91724167,18306005.12,-93.30974983,36.20940866,-31.159988,-11.10599938,85.95131536,286155400
230.080002,230.720001,221.309998,226.720001,6133200,45366833.06,-3.979796897,4218194.521,249.839996,226.720001,18.96250746,23.34918978,18152076,-89.2359689,33.37351899,-30.190003,-13.15406315,135.8197478,280022200
220.929993,224.369995,218.360001,220.690002,6158400,41151746.75,-5.485868412,2271950.352,249.839996,220.690002,7.40152913,13.35688585,17988953.25,-95.20082213,30.42088334,-27.739991,-16.12571975,78.59752915,273863800
222.990005,223,215.270004,215.580002,3836300,8085007.79,-7.01095728,-9252016.507,243.029999,215.580002,1.116707694,9.160248096,17846357.65,-99.39969404,28.14816175,-31.069992,-16.08734629,1.66693168,270027500
213.279999,222.520004,211.130005,219.25,5171500,38014639.32,-7.833167154,-3602209.599,237.699997,215.580002,30.56077322,13.02633668,17911666.18,-85.44281975,32.07321102,-29.149994,-11.74576091,5.517128808,275199000
220.669998,220.949997,215.429993,216.880005,3104400,42720336.68,-8.577141247,533815.9864,230.720001,215.580002,29.35171605,20.34306565,17855764.56,-89.69164557,30.89933392,-23,-12.06973028,-16.16979909,272094600
216.429993,221.729996,213.699997,221.309998,2844200,23708093.7,-8.708891978,-3872052.312,224.369995,215.580002,76.88822273,45.60023733,17919175.06,-79.07934204,35.64098785,-26.260009,-10.90579575,-42.30363518,274938800
223.039993,230.479996,222.869995,227.009995,4334500,37463991.72,-8.258168238,-945571.5812,230.479996,215.580002,82.06716995,62.76903624,17992429.47,-63.57799707,41.22911315,-19.139999,-5.365186648,-5.215394708,279273300
226.5,231.149994,224.940002,228.100006,2507900,22661627.79,-7.723974478,-4372256.934,231.149994,216.880005,84.76528633,81.24022634,18013242,-58.88052938,42.26154843,-13.360001,-7.864442561,-43.31148282,281781200
227.720001,228.600006,202,213.029999,14900000,162318680.8,-8.419589903,39059730.18,231.149994,213.029999,37.83876937,68.22374188,17847551.21,-76.9439801,33.49949162,-18.930008,-13.45520853,303.8049812,266881200
211.990005,214.809998,208.800003,210.089996,4151500,157720431,-9.103168155,51813397.24,231.149994,210.089996,27.75299371,50.11901647,17641917.99,-83.08947183,32.10119021,-16.630005,-12.99180406,-20.54849575,262729700
211.559998,215.75,209.399994,211.720001,2825200,6856474.17,-9.404966464,4318329.57,231.149994,210.089996,33.34477873,32.97884727,17674127.83,-79.68227046,33.75223798,-8.970001,-8.725644675,-58.53830349,265554900
215,215.350006,207.690002,209.089996,4235500,7229768.107,-9.744039995,-15385270.91,231.149994,209.089996,24.32246127,28.47341124,17639032.94,-82.71997033,32.38394363,-6.490006,-7.776113674,-30.94143351,261319400
211.380005,215.880005,210,215.259995,3391400,19949428.12,-9.406459052,-18000009.2,228.600006,209.089996,49.84959402,35.83894467,17764017.54,-62.85715374,38.66586382,-3.990005,-2.460468055,-44.93050143,264710800
214.839996,217.100006,207.509995,210.350006,3519400,24999124.04,-9.426456477,-15826588.97,217.100006,209.089996,29.61426217,34.59543915,17686661.15,-71.35503356,35.81432398,-6.529999,-2.426011667,-8.260563564,261191400
211.309998,213.449997,208.300003,212.960007,2728600,19973656.6,-9.126494763,-15097694.06,217.100006,209.089996,56.83009123,45.43131581,17730329.5,-62.40134046,38.41434081,-8.349991,-2.868867959,-47.23774534,263920000
211.75,213.75,210.639999,211.630005,1805000,13012223.66,-8.89357341,-15641993.52,217.100006,209.089996,42.96147314,43.13527551,17713288.54,-66.96395546,37.57897015,-15.37999,-2.420693415,-41.85671949,262115000
210.399994,211.630005,203.889999,206.929993,4438900,11355314.62,-8.98466364,-14969860.41,217.100006,206.929993,23.01281142,40.93479193,17673201.97,-83.08749909,34.70666808,-21.170013,-6.497675265,56.06849026,257676100
208.919998,215.800003,207.220001,213.789993,3927900,35684863.34,-8.406404832,-5592780.413,217.100006,206.929993,74.9431397,46.97247475,17820357.31,-59.55404656,41.70977563,0.759994,-5.823533012,-9.38055139,261604000
213.850006,214.440002,207.75,208.350006,8332500,22300461.5,-8.291512652,-5506940.964,215.800003,206.929993,37.44756929,45.1345068,17720410.04,-78.21609843,38.2098728,-1.73999,-8.658482894,232.2500897,253271500
227,232.740005,225.199997,231.630005,12726400,77371707.34,-6.2499133,12551475.3,232.740005,206.929993,96.1525138,69.51440759,18651442.37,-3.610929797,55.44127636,19.910004,8.731167482,-14.58791946,265997900
230.580002,234.580002,229.190002,231.770004,4496800,89214752.48,-4.567977554,22566207.66,234.580002,206.929993,90.84393051,74.8146712,18659134.31,-8.624916598,55.52160628,22.680008,10.31939093,8.317475611,270494700
230.699997,233.360001,229.5,232.360001,2445300,15617475.01,-3.151099616,1194354.637,234.580002,208.350006,91.88596155,92.96080196,18670581.43,-6.813998968,55.88257064,17.100006,9.748724685,-13.44683562,272940000
232.990005,232.990005,224.309998,225.330002,3850900,6889623.129,-2.565897737,-10434297.62,234.580002,208.350006,65.52367011,82.75118739,18596599.43,-30.14010784,50.61198639,14.979996,7.766993309,-9.080391925,269089100
223.479996,223.699997,216.080002,216.5,4617000,-1893830.035,-2.782552861,-17037636.13,234.580002,216.5,2.270259459,53.22663037,18445694.3,-58.91169838,44.88561179,3.539993,0.576049907,36.13846789,264472100
217.770004,219.479996,213.630005,219.080002,3347800,15593203.67,-2.714774774,-12626069.69,234.580002,216.5,26.01430921,31.26941293,18500714.48,-50.50504557,46.78032092,7.449997,4.150223794,-4.875831108,267819900
217.850006,219,212.660004,212.940002,2915900,16045916.88,-3.12053525,-9529468.336,233.360001,212.940002,1.352647539,9.879072071,18406888.06,-70.51156039,42.99238914,6.010009,-0.009393783,6.864326028,264904000
212.949997,212.990005,206.520004,207.190002,3430300,-2747459.462,-3.86156656,-13376072.22,232.990005,207.190002,2.531159708,9.96603882,18328150.27,-89.2473031,39.74658072,-6.599991,-2.098002597,90.04432133,261473700
206.089996,214.979996,205.800003,214.309998,2925400,23904847.55,-3.830163301,-5253396.836,223.699997,207.190002,47.54188744,17.14189823,18446031.07,-66.04757908,45.25782821,5.959992,3.566425965,-34.09628512,264399100
215.199997,216,211.399994,214,2148700,29334046.98,-3.786640208,274569.8987,219.479996,207.190002,59.94152921,36.67152545,18441799.49,-67.05767347,45.06455701,-17.630005,0.09823051,-45.29646885,262250400
214.5,221.380005,212.520004,221.070007,2811900,28595786.04,-3.145399162,2276148.727,221.380005,207.190002,98.01028267,68.49789977,18512786.99,-44.0208331,50.2795543,-10.699997,6.105111895,-66.25382538,265062300
220.539993,226.190002,220.300003,221.800003,2504400,25833362.3,-2.548924027,2009100.809,226.190002,207.190002,78.469842,78.80721796,18522072.17,-44.40583546,50.79890597,-10.559998,-4.243837926,-80.32122203,267566700
223.490005,225,213.580002,220.009995,4400700,28263563.1,-2.195345297,2490454.115,226.190002,214,69.6909892,82.05703796,18501860.74,-50.62546041,49.4353184,-5.320007,-5.073999567,-2.137075254,263166000
217.350006,219.179993,214.679993,217.75,2526200,33326255.51,-2.073591246,4071823.134,226.190002,214,42.93443249,63.69842123,18456655.7,-58.47811878,47.69457465,1.25,-6.287657487,3.308387519,260639800
215.369995,221,215,218.25,2480300,13876856.22,-1.914683186,-1839864.144,226.190002,217.75,41.91658258,51.51400142,18462456.39,-56.74080114,48.12974878,-0.830002,-3.142059174,-35.59167987,263120100
221.339996,230.830002,220.380005,229.639999,3990800,43424498.88,-0.859758909,5310501.372,230.830002,217.75,93.10143188,59.31748232,18591897.92,-13.49783117,56.92217048,16.699997,6.069283603,-13.56291964,267110900
231.059998,232.25,227.009995,231.610001,1949400,45229485.68,0.133697695,8327192.033,232.25,217.75,96.5720457,77.19668672,18626133.62,-5.075409704,58.2406446,24.419999,5.71937141,-41.7707151,269060300
231.789993,234.279999,229.080002,230.259995,2659800,9811469.788,0.802830478,-2465093.393,234.279999,217.75,79.48978179,89.72108646,18614770.97,-14.11518457,56.9541821,15.949997,8.133743232,-8.782880071,266400500
231.059998,238,231.050003,237.190002,3734000,23573883.69,1.870751817,-2277069.972,238,218.25,96.47826957,90.84669902,18694821.49,-2.515521973,61.63852725,23.190002,14.47946315,8.853453051,270134500
237,238.600006,231.229996,231.990005,2981500,22083496.14,2.271308639,-2467359.158,238.600006,229.639999,63.72118201,79.89641112,18612959.74,-20.15244023,56.65633477,10.919998,8.24973504,1.91768647,267153000
235.479996,237.449997,230,232.710007,2939600,5687968.534,2.616687407,-7537658.141,238.600006,230.259995,49.18038473,69.79327877,18622213.1,-17.95731238,57.17252058,10.910004,8.742993925,36.80830269,270092600
232.460007,233.270004,227.660004,230.380005,2573600,11770445.02,2.671594403,-6991296.283,238.600006,230.259995,24.86289308,45.92148661,18592780.44,-25.06097637,54.8942034,10.37001,4.211334738,-8.474696824,267519000
227.699997,235.630005,226.149994,231.130005,3144200,19840053.41,2.743996245,-3564609.556,238.600006,230.380005,40.0000498,38.01444254,18601158.77,-27.46322685,55.50880065,13.380005,4.20649318,25.54703721,270663200
227.520004,228.800003,224.199997,226.720001,2687600,19723152.88,2.417655531,-1875923.378,238.600006,226.720001,17.50001684,27.45431991,18541166.84,-45.55216292,51.09980285,8.470001,3.049864166,-38.92789783,267975600
226.699997,227.5,220.720001,224.520004,3057800,15833162.55,1.958925518,-2252282.922,237.449997,224.520004,22.71371135,26.737926,18515087.49,-56.27497901,49.00849858,-5.119995,3.109071871,21.04346449,264917800
224.710007,228.490005,223.639999,227.070007,2071700,16775051.58,1.780616767,-1901803.231,235.630005,224.520004,42.58889535,27.60087451,18549816.68,-46.08312213,51.48683845,-4.539994,4.041240321,-16.47381365,266989500
225.240005,225.75,216.639999,217.020004,3268700,4609159.048,0.818914609,-5456499.779,235.630005,217.020004,2.001078883,22.43456186,18458124.29,-90.21735063,42.68205686,-13.239991,-5.495556112,-18.09411647,263720800
217.509995,220.919998,214.869995,218.580002,2827100,7504875.799,0.180556182,-5493283.966,228.800003,217.020004,26.63320078,23.74105834,18481620.59,-84.36575946,44.27505241,-18.61,-5.62583608,45.02410998,266547900
221.820007,222.220001,218,221.089996,2244400,15729302.22,-0.121412366,-2392079.638,228.490005,217.020004,45.66810891,24.76746286,18514084.69,-73.78846137,46.83529266,-10.900009,-3.982454269,-15.61771562,268792300
222.100006,234.880005,220.729996,234.509995,5104300,76537971.92,0.713927437,18442269.73,234.880005,217.020004,98.15087549,56.81739506,18650318.11,-17.23560516,57.95735988,1.799988,-1.129898806,36.69791109,273896600
233.940002,237.759995,229.809998,233.389999,3298600,80199575.61,1.270915608,26453898.4,237.759995,217.020004,80.90871123,74.90923187,18625940.49,-21.95535013,56.88774006,3.009994,0.603471688,10.63558611,270598000
232.889999,235.899994,229.289993,230.460007,3014200,11041789.15,1.459087428,5321732.763,237.759995,218.580002,68.10839668,82.3893278,18584529.67,-34.30255047,54.07609303,-0.669998,-0.966868606,2.537760239,267583800
231.690002,235.830002,231.080002,232.559998,1953200,2592092.125,1.757408364,-6495577.94,237.759995,221.089996,73.68421905,74.23377565,18611995.57,-25.45303498,55.76364492,5.839997,0.946259637,-24.10631023,269537000
234.990005,236.550003,229.630005,229.949997,1961500,302969.8113,1.762902939,-11467782.33,237.759995,229.949997,54.13976243,65.31079272,18590074.98,-34.11969419,53.14952436,5.429993,-0.510538647,-37.61529165,267575500
232.179993,233.449997,228.130005,229.699997,1555000,102103.5566,1.727174724,-12523252.27,237.759995,229.699997,16.30315296,48.04237815,18587942.45,-35.21187418,52.89374658,2.62999,1.314394842,-42.14168775,266020500
230.559998,231.880005,228.279999,230.570007,708000,2708929.441,1.748902138,-10987113.35,236.550003,229.699997,28.97865296,33.14052278,18593832.15,-31.41104412,53.72828803,13.550003,2.694638737,-76.8460985,266728500
231.490005,231.979996,225.539993,228.949997,1901300,6952578.725,1.616762964,-8009612.35,236.550003,228.949997,30.97185198,25.41788597,18588857.67,-38.48841415,51.88501598,10.369995,0.827934092,-8.225129121,264827200
230.059998,237.720001,229.550003,237.190002,2406300,23816915.18,2.152132808,-697471.9471,237.720001,228.949997,95.64861534,51.86637343,18657286.24,-2.490139799,59.49656067,16.100006,9.294073186,-26.38357757,267233500
236.600006,243.630005,235.669998,238.089996,3697900,24603274.22,2.61885078,2607469.909,243.630005,228.949997,69.37531606,65.33192779,18666416.71,-19.26288969,60.23646282,3.580001,8.925790933,30.80188179,270931400
238.509995,243.449997,238.369995,240.009995,2715000,8989340.334,3.107830868,-1245621.015,243.630005,228.949997,79.98890216,81.67094452,18696237.22,-12.58695668,61.83807984,6.619996,8.557600679,20.96774194,273646400
230.720001,231.380005,219,223.410004,6827100,28326482.83,2.131302244,3444079.947,243.630005,223.410004,17.90500652,55.75640825,18508457.64,-70.30595956,44.97219066,-7.050003,-4.733269898,33.75193464,266819300
226.360001,226.889999,220,223.429993,3186800,35042747.91,1.343521934,7186489.236,243.630005,223.410004,17.98616362,38.62669077,18509068.47,-78.81392142,44.99164649,-9.130005,-4.267537616,-3.38931668,270006100
220,220.050003,215.979996,219.039993,3779100,19956576.74,0.360804917,3264012.277,243.630005,219.039993,11.06689332,15.65268782,18446453.55,-88.93310668,41.51964919,-10.910004,-4.955312702,25.37655099,266227000
214.190002,218.440002,213.669998,215.649994,3554300,15584781.31,-0.683669075,-28391.59424,243.449997,215.649994,6.648744347,11.90060043,18387965.85,-93.39120315,39.01580231,-14.050003,-7.271243613,81.97317223,262672700
217.860001,220.440002,210.770004,211,3628100,2251206.383,-1.865137746,-5615204.146,231.380005,211,1.115943662,6.277193778,18311325.58,-99.30007306,35.82447444,-19.570007,-8.240920742,84.96558756,259044600
214.009995,214.449997,203,207.850006,4091400,14777596.58,-3.020816281,-3404575.66,226.889999,207.850006,20.3014073,9.355365102,18257162.11,-88.06299433,33.80712496,-21.099991,-9.512403694,163.1125402,254953200
211.600006,213.740005,205.309998,209.970001,3091900,30510482.71,-3.722720759,2815197.549,220.440002,207.850006,39.96559748,20.46098281,18298892.91,-82.84518793,36.40279299,-27.220001,-8.934382346,336.7090395,258045100
212.009995,212.649994,200,200.309998,4126400,10279423.54,-5.000820281,-1333432.015,220.440002,200.309998,1.516624118,20.59454296,18156645.14,-99.28948438,30.52833128,-37.779998,-12.50928123,117.0304528,253918700
202.210007,210,193.380005,206.179993,6490700,78842929.73,-5.476929192,18906283.5,220.440002,200.309998,47.3022521,29.59482457,18277567.45,-74.52738706,37.16403261,-33.830002,-13.07391068,169.7377717,260409400
198.970001,205.070007,197.25,204.990005,5578600,124710353.8,-5.882461664,40061594.45,214.449997,200.309998,55.10206174,34.64031265,18240105.74,-76.89552239,36.40488146,-18.419999,-13.9023023,50.85859542,254830800
208.710007,210.470001,200.779999,204.720001,4038700,56637261.61,-6.154688716,23414456.47,213.740005,200.309998,55.69742633,52.70058006,18232757.85,-77.43284378,36.22407455,-18.709992,-14.70355182,48.75506446,250792100
199.399994,201.279999,191.25,198.699997,5838600,55511639.09,-6.778061355,14117524.09,212.649994,198.699997,34.81307985,48.53752264,18113995.69,-85.77702121,32.36453071,-20.339996,-11.06038519,-14.47906139,244953500
201.550003,203.229996,195.020004,199.970001,3166200,56411154.77,-7.087904997,9317031.829,210.470001,198.699997,45.36940971,45.2933053,18151313.48,-83.29501628,33.96305286,-15.679993,-10.49992961,-0.646416468,248119700
204.800003,205.5,199.029999,202.550003,3124100,23987867.92,-7.044074015,-3810309.171,210.470001,198.699997,58.79293659,46.32514205,18192163.62,-71.84151111,37.20970894,-8.449997,-7.528301008,-17.33216903,251243800
200.059998,203.570007,195.880005,196.380005,2698700,8398529.175,-7.421652728,-13794437.44,210.470001,196.380005,26.69097156,43.61777262,18096998.52,-85.60604617,33.02776551,-11.470001,-8.93577071,-24.07225051,248545100
196.699997,197.820007,188.880005,193.559998,4964200,19693043.6,-7.85785709,-13031104.65,205.5,193.559998,28.15881112,37.88090642,18058245.33,-85.17112343,31.29648556,-16.410003,-8.265403791,36.82643808,243580900
192.380005,193.259995,185.770004,188.070007,3617200,26680054.82,-8.548012415,-9311046.33,205.5,188.070007,11.65739213,22.16905827,17917444.47,-93.36601346,28.19759458,-12.239991,-9.516477474,-11.59016474,239963700
190.789993,191.279999,182.410004,189.699997,4592800,38476498.98,-8.86129146,-3189331.482,205.5,188.070007,31.57208429,23.79609585,17948794.5,-80.83094035,30.4010851,-16.479996,-9.65376192,48.54296711,244556500
189.949997,193.740005,188.080002,191.199997,2852300,40282520.64,-8.886096507,179588.8897,203.570007,188.070007,41.54060375,28.25669339,17985110.79,-72.56555893,32.45533946,-13.790008,-4.547951221,-30.87679333,247408800
188.759995,199.520004,182.75,196.940002,5297600,81977089.74,-8.346372467,14807911.13,199.520004,188.070007,84.92108708,52.67792504,18070739.53,-53.62273369,39.78016081,-7.779999,-4.481516788,-18.38168456,252706400
192.419998,193.119995,180.229996,182.779999,5773600,84449215.96,-8.957969285,20232636.65,199.520004,182.779999,13.21929467,46.5603285,17689841.64,-92.13447515,30.88284394,-15.919998,-10.83467752,3.495500663,246932800
183.589996,183.940002,170.179993,173.479996,7931400,30235674.08,-10.07693604,3362748.615,199.520004,173.479996,11.24744977,36.46261051,17396075.93,-91.80937616,26.66459721,-26.490005,-15.2598695,96.38497536,239001400
170.699997,175.979996,166.990005,175.330002,4385400,56401546.71,-10.69120369,4481231.29,199.520004,173.479996,25.6378643,16.70153625,17480657.08,-80.81877238,28.74946049,-27.220001,-11.76144708,-24.88952831,243386800
171.300003,173,157.740005,162.600006,9437600,75691980.73,-12.0661287,10669273.09,199.520004,162.600006,11.63236265,16.17255891,17162251.08,-90.78323275,23.74672601,-33.779999,-18.68780058,198.0734003,233949200
157.100006,157.149994,146,147.990005,9313000,50316893.36,-14.17131358,4156919.386,193.119995,147.990005,4.223270822,13.83116592,16314260.05,-96.65545378,19.54346801,-45.569993,-26.93655749,198.1018533,224636200
142.320007,159.789993,141.050003,148.25,8651600,67845944.07,-15.63843815,6692298.15,183.940002,147.990005,16.78712326,10.88091891,16330621.52,-88.8285534,19.81547015,-39.820007,-24.50860769,220.5839849,233287800
150.5,154.970001,141.740005,143.669998,10406500,68159954.93,-16.97503519,7221020.36,175.979996,143.669998,7.500702906,9.503698997,16063340.94,-95.93484077,18.62119623,-46.029999,-25.77495377,109.6309577,222881300
152,163.259995,147,150.470001,14252400,49441081.21,-17.28632853,824854.1371,173,143.669998,29.48356458,17.92379692,16555887.98,-84.93282566,25.77411171,-40.729996,-19.99255841,294.0174721,237133700
155,157.009995,143.699997,151.039993,7235800,88110240.29,-17.28775468,10437077.29,163.259995,143.669998,44.97971003,27.32132584,16609877.17,-82.91433243,26.35841623,-45.900009,-20.37954908,57.54659467,244369500
158.699997,162.949997,154.110001,155.169998,5593800,50871591.79,-16.76240149,1571864.299,163.259995,143.669998,63.57496662,46.01274708,16807731.32,-75.85087266,30.62012586,-27.610001,-18.84414203,96.11541563,249963300
159,169.339996,156.679993,168.679993,5825200,70605074.68,-15.08205507,4081124.968,169.339996,143.669998,97.608684,68.72112022,17294759.82,-52.74501535,42.36922323,-4.800003,-14.34955251,9.95922682,255788500
172.419998,172.949997,164.770004,166.770004,3887600,74436829.54,-13.74603287,5955824.065,172.949997,150.470001,78.8718188,80.01848981,17228800.2,-56.01162894,41.3042801,-8.559998,-8.759161335,-32.66592767,251900900
163.660004,167.490005,162.5,166.580002,2959400,16372780.76,-12.55779874,-12293616.74,172.949997,151.039993,78.22223932,84.90091404,17224371.03,-56.33658532,41.19335876,3.979996,-3.977400368,-62.6875457,248941500
170.119995,178.910004,169.850006,177.740005,5060100,50805394.23,-10.5934806,-7685863.989,178.910004,155.169998,95.28226267,84.12544026,17422635.61,-29.53714685,49.73223043,29.75,1.374552542,15.38514161,254001600
176.160004,181.729996,173.679993,177.210007,5984400,57035568.1,-8.97604053,-3119831.27,181.729996,166.580002,81.9561339,85.15354529,17407547.03,-15.69129204,49.36562964,28.960007,8.985240136,-36.58981097,248017200
172.75,179.5,167.839996,179,5395600,77748385.82,-7.463732877,5622154.231,181.729996,166.580002,85.80344999,87.68061552,17467995.28,-6.710905776,50.68775317,35.330002,20.95411443,-42.06378181,253412800
178.649994,188.520004,175.199997,187.429993,5750700,129843988.6,-5.521341594,25263189.72,188.520004,166.580002,95.81087305,87.85681898,17722100.7,-2.29621019,56.45449508,36.959992,26.4283258,-33.53021406,259163500
188.699997,192,185,190.339996,6065100,100809754.3,-3.704466799,21763339.71,192,177.210007,93.12912365,91.5811489,17811384.99,-3.258104215,58.26870882,39.300003,32.48416416,-41.71815692,265228600
192.399994,196.350006,189.220001,191.929993,4499000,40352557.49,-2.111935882,-883283.3509,196.350006,177.210007,84.49662768,91.14554146,17862049.55,-7.992789801,59.26727339,36.759995,27.55365968,-68.43338666,269727600
194.25,195.949997,182.699997,186.350006,6712200,29039662.46,-1.285285997,-13667069.99,196.350006,179,64.92460017,80.85011717,17731249.97,-18.31166419,54.35196108,17.670013,23.37792283,-7.236242019,263015400
183.729996,188.520004,181.5,188.339996,4862400,52770530.26,-0.464233056,-10103609.31,196.350006,186.350006,62.12762841,70.51628542,17802928.05,-15.21369161,55.76106563,21.569992,21.37655373,-13.07519039,267877800
188.279999,197.419998,184.220001,195.740005,4829000,88149615.89,0.774646554,3529661.783,197.419998,186.350006,89.44727883,72.16650247,17993975.12,-3.127313791,60.62819066,29.160003,16.04221788,-17.10155874,272706800
198,204.029999,197.5,201.039993,6489100,75015591.46,2.159241912,4607022.932,204.029999,186.350006,86.72877882,79.43456202,18124728.37,-5.989595593,63.7078839,23.299988,20.54925237,66.91789279,279195900
197.679993,209.699997,197.399994,205.289993,5329400,60138264.25,3.558463438,-104753.7044,209.699997,186.350006,84.36168628,86.84591464,18261908.41,-8.317622911,66.00427136,28.079986,23.23807812,80.08380077,284525300
203.5,207.5,202.199997,202.600006,4178700,37946372.64,4.399581472,-9083832.05,209.699997,188.339996,74.82272427,81.97106312,18192075.41,-15.04235477,63.27521539,23.600006,13.98672235,-17.41862809,280346600
204.520004,209.369995,202.789993,208.720001,3208600,16518265.83,5.496644131,-18749322.44,209.699997,195.740005,96.15386125,85.11275727,18318302.57,-2.076262844,66.6533587,21.290008,17.7811595,-46.38393156,283555200
210,213.289993,200.669998,205.179993,5192500,38791355.3,6.011132538,-13912010.73,213.289993,201.039993,48.96160786,73.31273113,18263882.92,-17.84378556,63.04108735,14.839997,14.62569441,-3.764178219,278362700
207.929993,209.419998,205.330002,207.5,3343100,25766430.97,6.530790595,-14812676.34,213.289993,202.600006,63.56203043,69.55916651,18322595.45,-12.73925937,64.40267446,15.570007,10.70800179,-41.86620759,281705800
212.649994,216.720001,210.639999,215.149994,4065700,22971565.7,7.473761065,-14723798.83,216.720001,202.600006,90.21802675,67.58055502,18445846.99,-3.211961619,68.52085732,28.799988,13.03456894,-32.96565597,285771500
214.270004,218.970001,211.5,218.339996,3180500,38772792.55,8.381857621,-8321249.594,218.970001,205.179993,96.55735029,83.44580249,18506128.61,-1.439353307,70.07549699,30,13.76022715,-29.30651256,288952000
218,222.580002,217.020004,221.929993,3516700,38342197.72,9.284191063,-5082555.115,222.580002,205.179993,97.03327758,94.60288488,18558423.13,-1.582300312,71.76545332,26.189988,19.09309678,-47.60734186,292468700
221.470001,228.5,220,226.380005,3782900,40047250.85,10.24033143,-2753067.276,228.5,207.5,90.85025817,94.81362868,18628937.97,-4.51062766,73.74477365,25.340012,20.19752034,-22.20097071,296251600
229.100006,234.479996,228.059998,232.740005,4711800,43965656.66,11.38009575,-303050.6511,234.479996,215.149994,92.70137912,93.52830495,18735216.1,-3.284241471,76.30177894,27.450012,18.90262545,-2.42700352,300963400
235.339996,239.880005,235,238.320007,5307800,36699414.61,12.58851415,-1585207.169,239.880005,218.339996,94.50317926,92.68493885,18848182.73,-2.672144341,78.2987111,35.720001,18.54358103,-18.20437349,306271200
237.210007,238.990005,232.559998,234.240005,4316000,19987759.09,13.06635161,-7282960.941,239.880005,221.929993,75.32808507,87.51088115,18757314.01,-10.13294933,73.4266578,25.520004,14.10200837,-19.01527376,301955200
232.369995,234.729996,222.029999,222.580002,4948800,2049951.934,12.36167871,-14659256.95,239.880005,222.580002,12.977874,60.93637944,18542472.08,-40.7250436,61.62512996,17.400009,9.861794377,18.42917654,297006400
215.779999,228.889999,215,227.75,4960900,60831691.4,12.08113221,2359107.876,239.880005,222.580002,51.24597041,46.51730983,18657420.8,-28.55461831,64.36036189,20.25,9.117477438,54.61260363,301967300
231.610001,234.809998,225,230.259995,3925700,81672689.55,11.92388163,15737928.54,239.880005,222.580002,61.33437272,41.85273904,18712094.06,-24.53457863,65.64079674,15.110001,12.22341498,-24.39672605,305893000
229.889999,232.380005,225.330002,230.130005,4014300,36815865.33,11.65442535,5507735.788,238.990005,222.580002,63.06795267,58.54943194,18709877.86,-24.86610115,65.50953128,11.790009,10.90602651,20.07717388,301878700
235.089996,235.5,226.5,226.889999,4033000,15702121.87,11.05203689,-5896055.604,235.5,222.580002,57.99999512,60.80077351,18653360.43,-33.12931314,62.17224309,4.960006,5.456660622,-0.804289544,297845700
229.339996,237.419998,225.009995,229.770004,8012900,30916651.13,10.68387497,-5184251.352,237.419998,226.889999,65.87870347,62.31555042,18704552.91,-29.26193957,63.93119159,3.389999,5.234958418,151.9383745,305858600
244.830002,247.899994,233.25,237.589996,15997500,91372796.99,10.89749249,14814283.28,247.899994,226.889999,54.97816288,59.61895382,18977263.93,-27.67042239,68.24842527,4.849991,7.056280581,354.9009014,321856100
249.119995,252.119995,243.639999,246.990005,13475300,95161201.73,11.69052696,22854150.48,252.119995,226.889999,81.07713021,67.31133218,19610188.92,-12.62922361,72.50817407,8.669998,9.104160944,256.2161305,335331400
240.5,256.559998,240,255.470001,9948700,190241991.8,12.8550918,54318515.67,256.559998,226.889999,96.54517624,77.53348978,20072841.2,-2.622707056,75.67822377,21.229996,9.766260854,111.144361,345280100
253.970001,267.73999,253.449997,265.420013,11705500,291466201.9,14.41473653,94459957.76,267.73999,229.770004,94.57061252,90.73097299,20460321.86,-4.398895411,78.77134912,42.840011,11.37126771,120.5339312,356985600
266.450012,269.339996,254.509995,257.200012,8856200,154788193.7,14.81668333,58805730.75,269.339996,237.589996,66.3619137,85.82590082,20097805.03,-22.34078928,70.76468254,29.450012,9.801915347,105.1946247,348129400
260.5,260.820007,248.020004,250.070007,7363900,25485049.69,14.3939725,-2267974.357,269.339996,246.990005,34.3217736,65.0847666,19852296.68,-35.46188888,64.62834627,19.810012,12.35061764,48.80172971,340765500
251,258.98999,245.300003,249.919998,9161700,45168623.72,13.88678839,-20783537.04,269.339996,249.919998,33.81049541,44.83139423,19847879.31,-35.73794521,64.50161745,19.789993,9.73435697,84.67818339,331603800
249.5,251.800003,243.630005,247.820007,5763200,57597420.29,13.16364728,-22514055.86,269.339996,247.820007,16.29717412,28.14314771,19770896.73,-39.60248543,62.64955716,20.930008,7.626167107,46.80693889,325840600
248.509995,255.5,247.330002,254.529999,4925600,56219792.23,12.98234067,-21613599.23,269.339996,247.820007,42.39594639,30.83453864,19926941.54,-27.25432111,66.00808815,24.759995,10.60269998,22.7013427,330766200
253,256.839996,251.050003,251.860001,4132200,34672455.32,12.47935313,-26136328.78,260.820007,247.820007,47.87664364,35.52325472,19875272.41,-39.42263549,63.55900076,14.270005,11.00533391,2.459707414,326634000
251.309998,254.600006,249.119995,254.509995,3752400,19956754.38,12.15445527,-30292774.92,258.98999,247.820007,70.8333374,53.70197581,19918750.16,-33.45364463,64.94903576,7.51999,10.76728492,-53.17051255,330386400
252.229996,258.309998,251.660004,253.880005,4271400,26800856.84,11.71113773,-27061581.66,258.309998,247.820007,69.82292158,62.84430087,19909461.82,-34.87478153,64.32088926,-1.589996,6.856353076,-73.29957806,326115000
253.119995,254.369995,241.25,247.369995,6357500,42152963.33,10.71103188,-18394824.92,258.309998,247.369995,35.87336294,58.84320731,19799934.27,-49.56011844,58.07089728,-18.050018,0.153848331,-52.82108747,319757500
246.259995,253.660004,241.5,249.970001,5194100,77933769.36,10.01281801,-1792274.802,258.309998,247.369995,51.11372815,52.27000422,19866755.38,-53.67136921,59.7529472,-7.230011,-2.152894656,-47.7911687,324951600
248.990005,250.899994,246.910004,248.289993,2783100,44437979.35,9.217660432,-5495139.774,258.309998,247.369995,41.26608338,42.75105816,19831846.67,-71.74507795,58.13021474,-1.780014,-6.453929305,-76.22399727,322168500
248.889999,254,245.710007,253.75,3786300,32347760.71,8.925185275,-10357277.76,258.309998,247.369995,73.2708175,55.21687634,19893048.27,-53.1356446,61.76451442,3.830002,-1.341373188,-57.24690048,325954800
253.009995,257.380005,250.759995,251.820007,3670300,31135602,8.440367004,-11790450.36,257.380005,247.369995,65.53009128,60.02233072,19864250.12,-62.37092024,59.78896343,4,0.699804035,-50.15820421,322284500
252.050003,255.729996,249.389999,253.740005,3223800,13819626.04,8.117499345,-16814517.84,257.380005,248.289993,77.07809286,71.95966721,19892234.27,-55.53575373,61.12123096,-0.789994,1.52849193,-64.81220734,325508300
252.75,255,249.399994,251.470001,3205800,17626898.94,7.590950297,-16129820.63,257.380005,248.289993,49.35728352,63.98848922,19863393.57,-47.77722359,58.64720625,-0.39,1.47284073,-44.37465297,322302500
249.850006,253.429993,247.440002,247.710007,2519000,2889921.358,6.791962772,-19072408.21,257.380005,247.710007,17.13796352,47.85777997,19815460.26,-63.58505839,54.69784067,-6.799988,-2.679445263,-48.85902225,319783500
248.139999,248.429993,237.809998,240.759995,5413800,10335415.38,5.534157198,-16173317.93,257.380005,240.759995,15.07407228,27.18977311,19744784.55,-85.60977073,48.23234966,-13.12001,-4.40721272,31.01495571,314369700
241.5,243.190002,234.820007,241.800003,3843900,38252779.21,4.568593273,-4634227.233,255.729996,240.759995,33.38115577,21.86439719,19768170.48,-70.2852334,49.20002711,-5.569992,-4.993906821,2.438439399,318213600
237.360001,238.910004,231.619995,232.320007,4302200,25314556.76,3.003794582,-3609103.889,255,232.320007,2.994062662,17.14976357,19617466.77,-97.3772502,41.57174748,-17.649994,-8.492200085,0.721075057,313911400
230.289993,234.460007,220.399994,222.559998,8700500,10551754.29,0.965005208,-7558890.228,253.429993,222.559998,6.539521845,14.30491343,19436726.8,-94.30228496,35.4736557,-25.729995,-10.02950944,36.85410932,305210900
228.460007,228.639999,209.789993,211.529999,11254800,20796777.86,-1.523220065,-5227759.845,248.429993,211.529999,4.503121118,4.678901875,19005532.94,-96.41383796,30.09997614,-42.220001,-15.37784608,116.6843149,293956100
210.869995,216.369995,208.110001,214.929993,5685200,47149419.36,-3.184101084,4586066.685,243.190002,211.529999,19.44125372,10.16129889,19186435.18,-86.15792278,33.44672123,-36.890014,-13.43590195,104.2758076,299641300
215.720001,216.149994,206.800003,208.919998,4776400,44214425.8,-4.92850489,7250037.161,238.910004,208.919998,6.602288801,10.18222121,19027462.38,-95.80863006,30.65290643,-44.820007,-17.66699586,26.14953913,294864900
207.550003,209.470001,205,208.690002,4070600,20742751.01,-6.25738499,212488.8151,234.460007,208.690002,12.52546206,12.85633486,19022204.13,-92.95532331,30.54774558,-42.779999,-17.12731467,10.90646541,290794300
207.589996,215.479996,206.050003,208.960007,5161900,25762378.89,-7.205682276,-1088671.075,228.639999,208.690002,16.75129935,11.95968341,19027470.71,-92.4398499,30.84767936,-38.75,-17.64798499,60.1184937,295956200
211.440002,211.669998,203.660004,207.279999,3650500,22666241.43,-8.000551931,-2507128.304,216.369995,207.279999,28.48149145,19.25275096,18985969.79,-93.26136461,29.98012498,-33.479996,-17.57267341,13.87173248,292305700
207.779999,211.199997,206.699997,207.610001,2822800,11530874.41,-8.505813729,-6402556.833,216.149994,207.279999,31.62530154,25.61936412,18991781.6,-92.41406259,30.39422892,-34.190002,-16.18828665,12.06034141,295128500
208.149994,213.149994,207.919998,208.289993,2949400,-1332687.356,-8.750497386,-11507042.08,215.479996,207.279999,39.17083023,33.09254108,19001027.21,-90.98171141,31.29588866,-24.030014,-13.48646066,-45.52070634,298077900
209.050003,209.820007,204.020004,204.660004,2843600,-2359401.656,-9.13205211,-12875827.68,215.479996,204.660004,8.460242613,26.41879146,18949626.33,-97.99075704,29.12680425,-17.899994,-15.35980088,-26.02304951,295234300
209.149994,215.309998,207.75,211.169998,5617500,15425668.34,-8.807606266,-6606369.726,215.309998,204.660004,64.46350101,37.36485795,19040077.9,-83.22538341,37.49384547,-0.360001,-9.103825914,30.57273023,300851800
213.619995,216.789993,207.300003,215.210007,6866300,69304879.89,-8.130759302,13702373.09,216.789993,204.660004,87.62735034,53.51703132,19147549.37,-70.78167573,42.06491638,0.280014,-3.302476216,-21.08154704,307718100
216.990005,220.550003,216.350006,220.279999,9007100,87988095.04,-7.103364065,26709484.23,220.550003,204.660004,98.36658187,83.48581108,19309308.05,-52.85107801,47.27583742,11.360001,4.136529117,-19.97103458,316725200
219.869995,222.600006,215.860001,216.220001,5102500,31825739.99,-6.541349244,11732599.98,222.600006,204.660004,65.66197894,83.88530372,19143297.48,-59.22079293,43.87276575,7.529999,0.600199154,-10.24941955,311622700
216.600006,218.740005,215.179993,217.910004,3013800,4531989.946,-5.891663896,-4145282.225,222.600006,211.169998,69.34639817,77.79165299,19183179.27,-42.95435207,45.62728925,8.949997,4.303085433,-36.90226949,314636500
217.910004,221.360001,216.509995,219.580002,3126800,15976785.17,-5.182290477,-6622409.898,222.600006,215.210007,80.26141564,71.75659758,19206276.14,-15.94510919,47.37781141,12.300003,5.218266278,-23.18577114,317763300
220.5,225.259995,219.050003,225.119995,4072400,33079358.08,-4.125519377,-1592015.304,225.259995,216.220001,98.61111139,82.73964173,19285165.16,-0.648148418,52.80596007,17.509994,7.733531517,-21.10656929,321835700
224.990005,225.929993,220.75,223.039993,3650300,30950227.32,-3.416476431,-66848.63727,225.929993,216.220001,73.11627907,83.9962687,19247538.11,-12.97710565,50.69169769,14.75,7.603239134,-0.005478702,318185400
223.039993,224.75,221.5,223.229996,2789000,9843162.925,-2.806867314,-6152723.797,225.929993,217.910004,74.88374884,82.2037131,19250647.73,-12.12392606,50.88514833,18.569992,7.523719919,-1.19739266,320974400
221.479996,222.399994,216.889999,219.559998,2982700,9947005.739,-2.590029615,-8050020.576,225.929993,219.559998,32.37795804,60.12599532,19204795.36,-28.60349415,47.04577131,8.39,5.410728013,1.129043195,317991700
219.589996,219.910004,217.110001,218.960007,2032800,9497439.288,-2.438489052,-8237411.259,225.929993,218.960007,22.89833378,43.38668022,19196644.54,-31.81191008,46.42900214,3.75,6.987199609,-28.51315234,315958900
220,221.940002,218.009995,218.990005,2229000,3582274.147,-2.289578639,-9447313.514,225.929993,218.960007,23.23017029,26.1688207,19196923.04,-31.67499536,46.46679046,-1.289994,3.703180885,-60.32042724,318187900
218,220.899994,215.449997,220.679993,2249500,12185349.07,-2.012005014,-6346084.824,224.75,218.960007,56.23649799,34.12166735,19214124.66,-23.96167337,48.66377884,4.459992,2.541696864,-67.23854186,320437400
222.240005,234.440002,221.520004,232.339996,6213600,77895218.82,-0.84146128,16407202.27,234.440002,218.960007,88.9415195,56.13606259,19332980.82,-7.737678988,60.65987498,14.429992,5.474848854,-31.01442196,326651000
233.800003,240.850006,232.610001,235.520004,5972000,79736731.28,0.338896544,24809737.12,240.850006,218.960007,79.01574759,74.73125503,19418025.57,-15.88674076,63.18648144,15.940002,8.92609514,17.04066634,332623000
234.979996,235.330002,227.059998,229.360001,4492100,20604641.39,0.768419995,7176951.213,240.850006,218.990005,54.76377587,74.24034765,19261828.49,-44.76041753,55.7209948,4.240006,5.254461378,49.05103192,328130900
227.389999,227.970001,218.419998,218.789993,6026600,3525758.838,0.252992773,-6123101.216,240.850006,218.789993,13.14958589,48.97636979,19054810.99,-85.93689843,45.73555911,-4.25,-0.359781853,92.74018166,322104300
219.5,225.770004,217.660004,217.869995,4193000,-6767239.077,-0.227105236,-14282430.98,240.850006,217.869995,0.905523855,22.93962854,19029469.53,-89.52083896,44.98000785,-5.360001,-3.220504691,2.961398684,317911300
218.880005,222.199997,212.529999,214.960007,3580200,2815456.739,-0.832798101,-13272896.22,240.850006,214.960007,8.580534602,7.545214783,18973465.58,-91.4194654,42.58370144,-4.599991,-3.622662416,-1.920390105,314331100
216.949997,221.899994,215.130005,217.699997,2908500,11689828.85,-1.079278515,-8829613.942,235.330002,214.960007,22.67542684,10.7204951,19019100.64,-81.74436186,45.52643591,-1.26001,-2.477265197,4.284689853,317239600
217.419998,218.039993,213.5,217.929993,2440300,16421818.7,-1.241743221,-4703582.244,227.970001,214.960007,34.97404987,22.07667044,19022173.41,-80.93222929,45.77765358,-1.060012,-0.742396163,-18.18486606,319679900
217.809998,219.990005,214.5,215.470001,3112600,11207960.16,-1.551118142,-4247016.793,225.770004,214.960007,22.20544479,26.61830717,18994627.32,-89.61863957,43.46857916,-5.209992,-1.593901118,53.11885085,316567300
219.5,223.75,218.229996,219.699997,3555500,3074508.163,-1.438393763,-6262064.124,223.75,214.960007,63.90371979,40.36107148,19055732.28,-74.68221671,48.29787428,-12.639999,0.324212057,59.51099148,320122800
220.679993,222.570007,218.809998,219.610001,4529000,2675765.537,-1.340864157,-6643995.766,223.75,215.470001,59.60976585,48.57297681,19054275.84,-74.99999912,48.20352457,-15.910003,-0.484861353,101.3336297,315593800
199.470001,205.949997,195.75,196.660004,23742400,39315.32846,-3.079940562,-7035111.435,223.75,196.660004,3.250014286,42.25449998,18580979.83,-97.98225304,31.37262007,-32.699997,-15.3568015,282.1037724,291851400
195.690002,197.550003,192.130005,196.399994,10130700,41089940.59,-4.428107311,6506004.87,223.75,196.399994,13.50407867,25.4546196,18549589.3,-91.23565494,31.23953622,-22.389999,-16.61005831,69.63663764,281720700
190.050003,195.119995,189.729996,193.149994,7026500,62570944.26,-5.693159809,18288962.26,223.75,193.149994,10.05290299,8.935665316,18381947.88,-93.30986438,29.55205029,-24.720001,-15.78741142,56.41904677,274694200
190.860001,198.809998,187.869995,198.550003,7205400,98244976.55,-6.188648543,32797458.54,222.570007,193.149994,30.77811039,18.11169735,18578391.91,-79.84143869,35.76115669,-16.410004,-9.250875564,19.55995088,281899600
201.889999,204.050003,199.410004,201.789993,6212400,88542051.85,-6.247865317,32663871.11,205.949997,193.149994,76.99113086,39.27404808,18695971.48,-70.67004647,39.22244547,-15.910004,-7.380549121,48.16122108,288112000
205.130005,211.779999,203,210.190002,5994900,53777270.51,-5.552973293,18578257.54,211.779999,193.149994,93.35007639,67.03977255,18954578.04,-44.33914299,47.17012696,-7.739991,-2.219019745,67.44595274,294106900
212.970001,213.5,209.020004,212.279999,4843100,56487307.74,-4.778537066,11989313.15,213.5,193.149994,95.23995021,88.52705249,19014187.55,-35.59367229,48.95855229,-3.190002,-2.489663792,66.51538594,298950000
206.139999,218.240005,206,216.5,5400000,70401950.66,-3.780690517,12631284.73,218.240005,198.550003,94.27064726,94.28689129,19110465.52,-20.20624022,52.45815579,-3.199997,-0.65617081,121.2842683,304350000
209.729996,214.539993,208,213.979996,5175300,86437481.29,-3.156843078,16847825.14,218.240005,201.789993,77.37648022,88.96235923,19047610.91,-27.22966176,50.24280211,-5.630005,-0.691513897,66.26935681,299174700
210,215.229996,209,214.440002,4919900,56645528.67,-2.595402662,7561895.373,218.240005,210.190002,75.06560529,82.23757759,19058736.57,-25.94759393,50.65247982,17.779998,-2.39417163,38.3743496,304094600
213.100006,218.119995,213.009995,215.940002,3612000,35182657.15,-2.006292334,-3753434.595,218.240005,212.279999,81.20913349,77.88373967,19093151.1,-21.76699251,52.03918899,19.540008,-1.671143838,-20.24729521,307706600
217.800003,219.809998,214.5,216.779999,4074800,16007630.18,-1.45486662,-14142356.84,219.809998,213.979996,78.05938133,78.11137337,19107201.62,-19.42586407,52.83843308,23.630005,10.23085253,-82.83745535,311781400
219.960007,226.779999,219.509995,224.779999,5429800,34086684.84,-0.368081613,-11354275.2,226.779999,213.979996,89.35037217,82.87296233,19257577.11,-5.140066292,59.72259852,26.229996,14.45010482,-46.40251908,317211200
224.100006,227.5,223.220001,224.649994,4571300,30614260.13,0.477212016,-10286351.91,227.5,214.440002,84.59456216,84.00143855,19254436.7,-7.191535807,59.5704217,22.860001,16.30856898,-34.94200527,312639900
225.5,225.589996,220.289993,222.529999,3567100,9423779.866,0.96492438,-15656776.85,227.5,215.940002,65.70048803,79.88180745,19211297.89,-12.54100523,57.01896278,12.339997,12.07756013,-50.49407389,309072800
223.119995,224.940002,221.050003,221.529999,2675800,4869579.581,1.256266837,-17879489.24,227.5,216.779999,54.07691538,68.12398852,19195268.15,-15.06434582,55.80479345,9.25,9.782450411,-56.92807933,306397000
222.520004,222.75,219.639999,220.399994,2234200,-1051498.338,1.380067317,-19047351.9,227.5,220.399994,11.13890417,43.63876919,19181619.13,-17.91573329,54.39522626,3.899994,4.85750602,-62.73165524,304162800
219.639999,227.089996,218.300003,226.25,3412100,26809870.26,1.928001878,-8928555.533,227.5,220.399994,86.41303905,50.54295287,19240920.78,-4.449982834,60.02468682,12.270004,6.580931348,-29.54719085,307574900
225,229.100006,224.75,225.259995,3115100,25638915.03,2.256349047,-4349937.727,229.100006,220.399994,64.44435247,53.99876523,19225990.41,-14.71268244,58.70402949,10.819993,4.046187067,-42.31296296,304459800
226.470001,229.800003,225,228.360001,2568500,6698411.941,2.73518165,-8107941.632,229.800003,220.399994,87.47824348,79.44521167,19268860.11,-6.050427809,61.55632777,12.419999,6.720256692,-50.37002686,307028300
226,227.850006,219.100006,220.5,4428700,10339654.37,2.452156611,-7749644.126,229.800003,220.399994,19.1304087,57.01766821,19180454.03,-39.07563793,51.78911775,3.720001,2.825964346,-9.983942763,302599600
221.990005,224.5,218.880005,222.270004,2579700,10201606.12,2.343665442,-6942479.214,229.800003,220.5,34.52174783,47.04346667,19216004.22,-34.54127506,53.5755277,-2.509995,2.931370724,-28.57973422,305179300
222.270004,231.389999,221.369995,230.009995,4490700,45902730.54,2.849391979,5378307.767,231.389999,220.5,88.96878767,47.54031473,19305835.75,-6.163483973,60.47287599,5.360001,6.102959711,10.20663591,309670000
227.690002,230,225.300003,229.509995,3430000,52263839.75,3.173258731,11953681.94,231.389999,220.5,84.9719832,69.48750623,19296073.78,-10.22852879,59.8542271,6.979996,2.10427797,-36.83008582,306240000
229.339996,233.360001,226.919998,228.490005,2889000,16433731.87,3.309471272,2156420.507,233.360001,220.5,66.36742165,80.10273084,19280830.15,-25.8218226,58.53858895,6.960006,1.70933056,-36.80134754,303351000
227.949997,230.759995,226.600006,230.610001,2419100,11964413.94,3.547592217,-3469644.014,233.360001,222.270004,81.00828205,77.44922896,19307635.12,-18.26029459,60.48283499,10.210007,3.63097202,-32.1830058,305770100
230.699997,235.279999,230.240005,234.789993,3070800,23286904.14,4.027172465,-1853183.161,235.279999,228.490005,96.4773123,81.28433866,19351483.26,-2.885783954,64.06128371,8.539993,5.985642604,14.76194035,308840900
235.5,236.630005,229.380005,230.009995,4016300,12536475.06,3.975707891,-4444023.597,236.630005,228.490005,41.57097236,73.01885557,19288966.04,-36.11570801,57.63403652,4.75,4.360254656,79.76456897,304824600
229.369995,229.869995,221.399994,227.199997,3934400,20442217,3.665920046,-2584447.374,236.630005,227.199997,38.08272364,58.7103361,19239899.5,-51.44575543,54.1919102,-1.160004,0.419888177,15.30728877,300890200
227.369995,229.699997,224.210007,225.789993,3887800,24953046.04,3.268952953,-153498.1011,236.630005,225.789993,28.82466073,36.15945225,19215482.6,-59.13808411,52.49762529,5.289993,0.23528279,24.80498218,297002400
225.690002,230.860001,222.050003,230.610001,4147000,38754387.86,3.305187886,5246271.554,236.630005,225.789993,60.47275343,42.46004594,19298476.65,-32.84235321,57.40068009,8.339997,0.985286386,61.45610278,301149400
230,232,227.399994,230.029999,3205200,42437664.29,3.249643155,8150286.043,236.630005,225.789993,56.66446991,48.65396136,19288046.62,-37.18313239,56.6430375,0.020004,4.321995011,-27.62661729,297944200
228,229.600006,226.089996,226.160004,2263600,4997049.54,2.860374682,-3315565.998,232,225.789993,44.9057293,54.01431755,19234122.75,-58.98592113,51.7361403,-3.349991,1.750123692,-12.25336279,295680600
226.820007,231.539993,226.649994,229.080002,2207800,2194321.265,2.755729712,-8596503.92,232,225.789993,70.65327758,57.4078256,19263348.56,-42.53522817,54.9100667,0.589997,-0.404327212,-50.83617253,297888400
228.240005,229.869995,224.619995,225.649994,2338300,4783201.513,2.368719713,-9151652.635,232,225.649994,36.18082498,50.57994395,19230291.23,-61.8592169,50.69291405,-4.960007,-1.681844401,-31.82798834,295550100
226.169998,227.570007,223.410004,224.910004,1880900,2147557.052,1.979482252,-9385404.653,232,224.910004,17.46217344,41.432092,19222623.08,-76.80205321,49.8042268,-9.879989,-1.566808579,-34.89442714,293669200
225.410004,226.649994,224.039993,225.610001,1813500,3743252.605,1.707806142,-8120090.562,231.539993,224.910004,27.06027032,26.90108958,19228477.08,-72.35716376,50.68494352,-4.399994,-2.16816269,-25.03410359,295482700
226.020004,229.5,224.929993,225.589996,2034300,1726732.82,1.47389647,-7505891.95,231.539993,224.910004,26.81420602,23.77888326,19228316.28,-72.48851626,50.65758827,-1.610001,-3.918394001,-33.7534193,293448400
225.490005,227.190002,223.410004,223.610001,2267100,-2091597.295,1.115889046,-7787198.286,229.869995,223.610001,3.095933106,18.99013648,19210461.31,-85.48913064,47.90193258,-2.179992,-2.78248517,-43.55252347,291181300
224.330002,224.830002,222.800003,223.240005,1787100,-2307154.906,0.793166865,-7262937.547,229.5,223.240005,6.56719697,12.15911203,19206710.05,-87.91851825,47.3832249,-7.369996,-1.742954248,-54.57757218,289394200
223.820007,225.660004,222.289993,223.509995,1714500,384453.1956,0.552820576,-5531779.435,229.5,223.240005,16.92095445,8.861361507,19208871.4,-86.14576838,47.82719037,-6.520004,-1.009787001,-55.90050929,291108700
223.539993,225.169998,222.529999,225,1659500,4989978.08,0.477075928,-2855295.069,229.5,223.240005,37.58674575,20.35829906,19220300.93,-66.03769847,50.31859122,-1.160004,-2.432678971,-59.98312033,292768200
224.169998,225.110001,222.679993,222.929993,2065500,2655480.434,0.247166303,-2243592.072,227.190002,222.929993,13.0612005,22.5229669,19205033.47,-91.15587673,46.96332495,-6.150009,-3.08655655,-35.5578435,290702700
224.320007,228.490005,222.800003,224.839996,4784400,5354431.235,0.216585882,-930629.9488,228.490005,222.929993,41.12900104,30.59231577,19222730.11,-71.95986089,50.25911077,-0.809998,-0.583661115,111.3624315,295487100
227.050003,227.149994,222.220001,222.619995,2570700,5357194.742,0.01306455,-308027.0596,228.490005,222.619995,6.379485563,20.1898957,19175490.42,-95.91008138,46.63192469,-2.290009,-2.819978585,16.43717728,292916400
223.110001,223.800003,220.770004,220.960007,1762500,-2650960.321,-0.278959063,-2573372.756,228.490005,220.960007,2.461178438,16.65655501,19156321.74,-98.23581064,44.07073474,-4.649994,-2.078434356,-24.62472737,291153900
222.139999,222.860001,218.820007,219.990005,2239000,-288049.4851,-0.581952549,-2514326.843,228.490005,219.990005,12.09925793,6.979973978,19148584.46,-90.80189239,42.59840806,-5.599991,-2.1875412,19.03875804,288914900
220.149994,220.399994,215,215.199997,3266300,-1463028.761,-1.19481757,-2635453.571,228.490005,215.199997,1.4825569,5.347664423,19099833.03,-98.65502981,36.1719195,-8.410004,-4.614158926,80.11028398,285648600
216.110001,216.110001,210.520004,211.339996,3168900,-2597661.457,-1.969286626,-2806438.22,227.149994,211.339996,4.930802724,6.170872519,19041246.03,-95.67970404,31.98442049,-11.900009,-6.316769472,55.77348474,282479700
210.429993,212.600006,208.649994,212.009995,3276500,10414050.32,-2.500175149,1518834.372,223.800003,211.339996,22.17821125,9.530523624,19051292.21,-83.88489193,33.42509262,-11.5,-5.187606077,44.52384103,285756200
209.009995,211.100006,200.5,200.770004,7943100,4923530.274,-3.784258885,1403204.566,222.860001,200.770004,1.207531252,9.438848408,18877584.22,-99.06895172,24.17417359,-24.229996,-10.06540069,344.4686923,277813100
202.330002,203.199997,196.199997,197.779999,5977400,-780013.8654,-4.985700857,-586426.6323,220.399994,197.779999,6.528934694,9.971559064,18759290.11,-95.10683924,22.39827764,-25.149994,-11.51178765,248.6380869,271835700
199.020004,203.25,199,202.830002,4390600,21198204.49,-5.4673352,5646014.322,216.110001,197.779999,33.29986774,13.6787779,18911913.68,-79.46731695,31.54518513,-22.009994,-9.853332444,164.5736668,276226300
205.5,206.5,200.710007,201.710007,3640900,17010940.58,-5.871722561,6350063.983,212.600006,197.779999,33.59760351,24.47546865,18887669.48,-82.93586672,30.68143578,-20.909988,-9.518677014,76.27208908,272585400
199.550003,199.889999,196.360001,197.360001,3377900,1585739.045,-6.468645074,1152787.085,211.100006,197.360001,7.785257042,24.89424277,18809151.13,-96.40754502,27.52862679,-23.600006,-12.22202254,-29.39762562,269207500
199.089996,199.919998,193.699997,194.470001,3757000,557914.9481,-7.093143965,-1405205.412,206.5,194.470001,6.01565484,15.79950513,18759687.56,-97.78670933,25.64329221,-25.520004,-12.64486328,46.14696386,265450500
195,201.369995,194.100006,198.300003,3715200,13635965.67,-7.196062949,1837287.015,206.5,194.470001,35.93753845,16.57948344,18833680.04,-86.77779551,32.26406738,-16.899994,-10.2552513,110.7914894,269165700
197.059998,198.490005,193.449997,196.050003,3589400,21629700.92,-7.374178244,5540196.313,206.5,194.470001,19.92341304,20.62553545,18791525.73,-92.28484798,30.54348498,-15.289993,-10.88231349,60.31263957,265576300
195.75,197.919998,194.860001,196.410004,2254500,9976707.861,-7.400973017,2843598.116,201.369995,194.470001,37.3738352,31.07826223,18798116.84,-90.24709583,31.17590086,-15.599991,-8.731409508,-30.97694639,267830800
196.490005,202.520004,196.399994,200.419998,3077200,13696423.44,-7.017738938,2665481.256,202.520004,194.470001,76.84669924,44.71464916,18844145.71,-76.30057786,37.95287941,-0.350006,-5.167028583,-2.893748619,270908000
200.419998,205.699997,199,205.399994,3107800,31065197.73,-6.240245447,7876726.972,205.699997,196.050003,97.55099592,70.59051012,18920607.36,-55.65863328,45.1732286,7.619995,-3.117778009,-5.148786815,274015800
207,209.429993,205,206.339996,2299500,21228124.32,-5.484998302,6162556.227,209.429993,196.050003,80.66334309,85.02034608,18934830.04,-43.1156367,46.44018054,3.509994,2.774314832,-71.05034558,276315300
206.850006,207.75,203.910004,204.639999,2410500,1284776.024,-4.966385647,-1444538.646,209.429993,196.410004,67.12425099,81.77953,18915884.89,-41.56659665,44.44010409,2.929992,3.468500371,-59.67310202,273904800
206.369995,207,201.559998,205.220001,2633500,8584318.39,-4.457200237,-2102628.647,209.429993,200.419998,67.69000519,71.82586643,18922716.86,-33.31445893,45.30559325,7.86,1.178326173,-40.0195873,276538300
206.399994,207.279999,203,206.429993,2382900,16477009.39,-3.910947917,330611.549,209.429993,204.639999,71.23679757,68.68368459,18938244.17,-18.77347153,47.15503853,11.959992,2.339986037,-34.55189651,278921200
205.990005,210.179993,205.669998,207.449997,2905200,11112761.06,-3.357035404,-410833.8903,210.179993,204.639999,68.32949439,69.08543239,18950018.46,-16.31797162,48.72893081,9.149994,5.112482747,-13.99390154,281826400
206.5,211,206.5,208.990005,2394400,8305245.643,-2.76195191,-1570104.304,211,204.639999,78.7076846,72.75799219,18971585.25,-11.45296101,51.09709527,12.940002,7.466449285,-36.26829917,284220800
209.649994,209.979996,204.610001,205.809998,3373200,6320988.373,-2.517918939,-2532969.122,211,205.220001,45.0211769,64.01945196,18935151.89,-29.57265591,46.33758107,9.399994,3.787188546,-9.205426357,280847600
207.509995,208.25,205.259995,206.270004,2088400,2154770.463,-2.261335148,-4022213.235,211,205.809998,40.87505,54.8679705,18942691.33,-26.95153955,47.10511955,5.850006,5.212956309,-41.81757397,282936000
205.600006,207.330002,200.580002,200.699997,2727000,-1624941.599,-2.478868803,-5468429.371,211,200.699997,1.151583714,29.01593687,18886297.27,-58.68946575,39.70049902,-4.699997,2.184202898,20.95808383,280209000
202.210007,204.979996,199.550003,204.029999,2586300,8782835.42,-2.355410752,-2251367.886,211,200.699997,39.12661287,27.0510822,18931543.49,-39.71509862,45.24232788,-2.309997,1.80121796,-15.95281425,282795300
212.300003,215.669998,208.25,213.699997,5999900,42240601.47,-1.460446218,9915025.364,215.669998,200.699997,87.77914633,42.68578097,19054121.13,-9.466608765,57.46688547,9.059998,4.040897392,93.05939893,288795200
213.100006,213.320007,208.820007,211.410004,3541500,38775772.41,-0.925297422,12888374.69,215.669998,200.699997,73.57323002,66.82632974,18989826.66,-22.10686619,54.37124912,6.190003,2.45711355,54.01174168,285253700
212.240005,213.149994,208.119995,208.460007,1877500,6557087.598,-0.730803995,2681674.724,215.669998,200.699997,55.27299481,72.20845705,18940408.87,-43.25130093,50.59053651,2.030014,1.866696647,-22.1115951,283376200
202.460007,204.210007,200.210007,201,4703400,-1171048.072,-1.165195129,-4196534.312,215.669998,201,8.9950214,45.94708208,18873220.14,-91.0049786,42.53564458,-6.449997,-2.05633027,78.59882286,278672800
201,201.320007,195.800003,196.610001,3493000,-209952.4951,-1.842450835,-6323040.842,215.669998,196.610001,4.076488192,22.78150147,18770494.16,-95.92351181,38.63708109,-12.380004,-4.757056791,46.58609258,275179800
201.350006,204.139999,199.660004,200.949997,3316300,1765497.571,-2.005857183,-5989601.144,213.320007,196.610001,29.39493621,14.15548193,18847599.12,-74.08155362,44.09253607,-4.860001,-3.133285174,14.15048878,278496100
201.850006,202.199997,198.309998,200.100006,2328400,4827499.238,-2.178828878,-4334411.541,213.149994,196.610001,24.78389182,19.41843874,18833571.63,-78.35931514,43.28095578,-6.169998,-4.253791467,-2.756431674,276167700
200.949997,203.880005,200.419998,201.509995,1970700,3709064.407,-2.177040298,-3619116.737,204.210007,196.610001,67.89523525,40.69135443,18849978.51,-71.2632439,45.08659455,0.809998,-2.089307148,-41.57773035,278138400
200.5,200.899994,197.050003,200.240005,2494600,8328320.983,-2.252139157,-1527722.068,204.139999,196.610001,53.23745959,48.63886222,18837558.44,-77.65474023,43.73604436,-3.789994,-2.923352346,19.45029688,275643800
200.660004,201.429993,196.300003,196.509995,4269900,4331669.154,-2.582862546,-1804929.642,204.139999,196.509995,2.678470754,41.27038853,18791089.79,-96.42681339,39.95088573,-17.190002,-2.087694102,56.57865787,271373900
197.050003,198.389999,192,193.960007,4554100,2570378.58,-3.015959828,-2314658.865,203.880005,193.960007,16.49836848,24.13809961,18735681.95,-91.71944586,37.55780365,-17.449997,-4.935544797,76.08552759,266819800
195.990005,199.470001,193.259995,199.100006,5680500,38604584.52,-2.910882737,9152668.241,203.880005,193.960007,59.76433512,26.31372478,18856366.98,-70.00419687,44.74284518,-9.360001,-6.832003372,-5.323422057,272500300
199.740005,206.660004,198.059998,203.559998,6991200,68767248.86,-2.43960209,22608998.14,206.660004,193.960007,78.8539894,51.70556433,18983614.51,-51.16181252,50.10750361,2.559998,-3.713166762,97.40787802,279491500
202.119995,203,197.050003,199.100006,5072900,43005882.7,-2.398346221,17861698.58,206.660004,193.960007,48.43113276,62.34981909,18830437.58,-70.00419687,45.36449098,2.490005,-4.490070366,170.1944075,274418600
198.600006,201.570007,197.410004,200.089996,2943400,13915479.81,-2.259718104,5039793.428,206.660004,193.960007,55.18413228,60.82308481,18855661.69,-62.05444023,46.57339141,-0.860001,-0.452738308,-37.41973891,277362000
201,203.949997,200.25,202.759995,2751600,12862636.25,-1.912363185,-998690.1243,206.660004,199.100006,70.89547477,58.17024661,18894938.39,-49.12530472,49.79956684,2.659989,3.12801687,-21.22530776,280113600
202.899994,204.690002,201.199997,202.339996,2445000,7162474.988,-1.651929899,-5191876.514,206.660004,199.100006,55.04674765,60.37545157,18889238.7,-29.4679865,49.29530308,0.830001,0.691713869,-26.27325634,277668600
201,203.190002,200.100006,202.240005,5632800,11463371.61,-1.437037804,-5066815.066,204.690002,199.100006,67.93197224,64.62473156,18888030.45,-30.15005317,49.16765654,2,1.069464736,141.9171964,272035800
211.339996,213.699997,201.649994,204.009995,13093700,30694277.44,-1.111102769,1563890.57,213.699997,200.089996,40.51561594,54.49811194,18937328.31,-44.65439327,51.55883851,7.5,1.24063325,564.4187345,285129500
204,205.320007,199.830002,199.970001,4280100,16800110.13,-1.165357146,-286591.3223,213.699997,199.970001,1.009365901,36.48565136,18678034.79,-63.27187972,46.2150362,6.009994,-0.134840188,71.57460114,280849400
202.490005,202.490005,195.809998,197.729996,4692300,2093844.116,-1.373273571,-5696819.343,213.699997,197.729996,10.73224208,17.41907464,18630090.37,-73.59448483,43.52160952,-1.37001,0.62083407,9.892503337,276157100
198.039993,198.5,188.110001,190.789993,7060000,19347385.8,-2.074139686,-1902438.512,213.699997,190.789993,10.47281133,7.404806435,18465398.23,-89.52718867,36.4364003,-12.770005,-1.634364759,55.02514218,269097100
190.050003,192.699997,187.509995,188.020004,4253400,12015640.63,-2.820582179,-2510070.862,213.699997,188.020004,1.947342348,7.717465251,18362897.46,-98.05265765,34.05346573,-11.080002,-5.565043529,-25.12278849,264843700
189,191.470001,187.039993,187.419998,2653000,-3083429.388,-3.421122136,-7334709.022,205.320007,187.419998,2.078800377,4.832984685,18349324.08,-98.57462512,33.54175483,-12.669998,-7.92886626,-62.05229431,262190700
189,193.460007,185.960007,190.559998,5146000,20264487.8,-3.602159171,-1212750.163,202.490005,187.419998,27.82814009,10.61809427,18393771.96,-83.4174742,38.73054494,-12.199997,-4.289305747,1.440990361,267336700
193.589996,194.289993,190.050003,193.210007,3870100,32925522.59,-3.491550329,5430448.637,198.5,187.419998,57.8150243,29.24065492,18465334.44,-73.86444624,42.79020798,-9.129989,-3.438447267,31.4839981,271206800
193.789993,197.490005,191.259995,194.940002,3267600,21931092.52,-3.227095932,4156215.974,197.490005,187.419998,77.88375158,54.50897199,18499987.16,-67.6279804,45.33659736,-7.300003,-3.856773127,18.75272569,274474400
186.880005,192,183.949997,190.059998,8173100,58655312.31,-3.372414363,14942080.19,197.490005,187.419998,45.12553464,60.27477017,18418188.15,-79.46218151,39.93668763,-13.949997,-6.068991916,234.2781186,266301300
191.050003,191.610001,180.419998,185.350006,6750300,77470711.33,-3.82356162,23982826.13,197.490005,185.350006,28.88111294,50.63013305,18215645.6,-85.18627359,35.53716973,-14.619995,-8.351462907,19.83915637,259551000
184.240005,188.880005,183,188.559998,3988500,51461716.03,-3.877383481,17225466.77,197.490005,185.350006,47.68597927,40.56420895,18332550.96,-75.54086465,40.3593545,-9.169998,-7.573156894,-69.53878583,263539500
188,188.25,178.190002,181.449997,6552200,38890200.17,-4.442544466,8895113.186,197.490005,181.449997,16.89116318,31.1527518,18182157.24,-90.81950026,34.24820764,-9.339996,-9.261391162,53.08520829,256987300
182.779999,186.429993,182.050003,183.770004,3902000,21272954.47,-4.64963534,-926892.6567,192,181.449997,40.40552359,34.99422201,18265933.21,-84.28610874,37.57002671,-4.25,-7.060128601,-16.84248663,260889300
182.649994,184.729996,181.210007,183.929993,3434400,12902709.63,-4.746136073,-7523982.709,191.610001,181.449997,42.77191824,33.35620167,18269330.27,-78.84264673,37.80338362,-3.490005,-3.59557642,-51.35410765,264323700
183.490005,189.490005,182.110001,188.660004,4887100,40021855.2,-4.390332225,-909974.8032,189.490005,181.449997,92.65486036,58.6107674,18357650.56,-56.91357734,44.41818672,-1.899994,0.340389313,14.8986693,269210800
190.649994,193,185,185.020004,5210300,26367841.3,-4.35190662,-2465978.283,193,181.449997,46.11750792,60.51476217,18263359.01,-66.37123253,40.82027879,-8.190003,-1.280543179,96.39276291,264000500
185.039993,188.889999,184.410004,184.520004,4361000,-8867256.559,-4.312092752,-14089512.82,193,183.770004,28.07463075,55.61566634,18249278.64,-67.20206727,40.3369468,-10.419998,-3.169602258,-15.25456665,259639500
185.839996,191.470001,183.710007,191.169998,5603400,37810473.19,-3.70127504,-2711725.403,193,183.929993,84.47834532,52.89016133,18406446.55,-32.74614517,48.98815125,1.11,-1.055850591,44.78695641,265242900
190.610001,195.639999,189,193.139999,4891900,59995315.96,-3.023383306,9248158.092,195.639999,184.520004,81.52253977,64.69183861,18464189.42,-22.53888769,51.24359825,7.789993,-0.923362564,49.70926674,270134800
193.639999,197.240005,193.639999,196.649994,2366100,25144796.1,-2.177817436,2211294.285,197.240005,184.520004,95.63923808,87.21337439,18553091.48,-4.352387924,55.05648035,8.089996,3.467324039,-71.05015233,272500900
195.479996,199.350006,194.550003,196.119995,4529200,10797190.21,-1.532797744,-5433596.807,199.350006,184.520004,79.34775443,85.50317743,18546714.51,-15.26469938,54.36513438,14.669998,5.810622418,-32.9037228,267971700
195.559998,196.729996,189.5,189.570007,4439300,-22507.70331,-1.53247882,-11509720.06,199.350006,189.570007,37.46803309,70.81834187,18395448.93,-46.2192682,46.58045315,5.800003,0.535643302,11.30249467,263532400
191,191.889999,187.5,189.399994,3547100,642022.7346,-1.528327096,-12737627.16,199.350006,189.399994,16.03369652,44.28316135,18391467.61,-47.02273213,46.3947516,5.470001,4.381370698,-45.86398462,259985300
188.25,188.529999,181,181.880005,5126400,4711517.874,-2.107542649,-10787147.32,199.350006,181.880005,4.795666007,19.43246521,18250632.59,-82.56142579,38.99036794,-6.779999,-1.028458921,31.37878011,254858900
182.880005,184.880005,180,181.470001,4042300,3101506.975,-2.570033301,-9520850.19,199.350006,181.470001,7.596902037,9.475421522,18239076.37,-84.49906248,38.62838989,-3.550003,-1.337461041,17.70032611,250816600
182.509995,188.889999,182.509995,186.800003,4072200,19253322.08,-2.477910053,-2998073.813,196.729996,181.470001,40.64557457,17.67938087,18357803.8,-64.85787653,45.68748135,2.279999,-0.985901071,-16.67451045,254888800
185.520004,186.580002,182.679993,185.850006,3391600,26252360.5,-2.453278664,2169853.64,191.889999,181.470001,49.20106385,32.48118015,18337094.07,-69.76742023,44.70057944,-5.319992,0.448601223,-34.90585955,251497200
186.149994,193.399994,185,193.149994,5461900,54468478.65,-1.823687751,13064602.13,193.399994,181.470001,98.13432752,62.66032198,18470312.46,-32.04139575,53.08663857,0.009995,4.676994262,25.24421004,256959100
192.050003,192.5,189.539993,192.289993,3194100,52909055.1,-1.378239819,15837673.38,193.399994,181.470001,91.71640674,79.6839327,18445993.34,-36.48584398,52.08454629,-4.360001,0.585863374,-42.9971089,253765000
190.869995,193.839996,190.809998,192.179993,2722500,10795432.59,-1.022310644,2132534.141,193.839996,185.850006,85.34860677,91.73311368,18444166.14,-37.05431926,51.9494691,-3.940002,-0.497051882,-44.34677733,251042500
192.800003,194.419998,191.179993,192.429993,2438900,3788930.244,-0.71185547,-5897322.123,194.419998,185.850006,83.04936838,86.70479396,18447707.74,-35.76233,52.25254775,2.859986,-2.145945146,3.076793035,253481400
193.179993,201.279999,193,198.149994,6823900,34114130.75,-0.004212671,1002784.305,201.279999,192.179993,80.77392388,83.05729967,18520204.29,-14.7086708,58.67512683,8.75,1.035080079,50.66457653,260305300
198.740005,203,196.759995,198.690002,4150900,37707695.33,0.593333894,4877799.818,203,192.179993,67.97922913,77.26750713,18538801.12,-18.73912174,59.23264695,16.809997,4.810884984,-6.496519722,264456200
198.410004,200.740005,197.389999,197.580002,3219600,2718962.161,0.96618851,-5113181.645,203,192.179993,55.53734938,68.09683413,18515611.73,-23.5652087,57.51498577,16.110001,4.318906156,-9.232894477,261236600
198.080002,202.589996,197.600006,202.490005,3796900,16065494.11,1.638981527,-4488942.837,203,192.429993,95.68532404,73.06730085,18595621.07,-2.217369565,62.67154318,15.690002,11.33164693,-25.9343789,265033500
202.490005,204.449997,199.839996,202.729996,3488100,27269945.32,2.166565293,-260434.0447,204.449997,197.580002,84.97815327,78.7336089,18600121.16,-7.034769779,62.90851473,16.87999,11.71543224,-13.71001657,268521600
203.050003,209,202.5,208.789993,4689100,38122098.73,3.038642758,4946044.186,209,197.580002,98.28425724,92.98257818,18704387.3,-0.724162069,68.36899977,15.639999,11.77194307,15.14905948,273210700
208.449997,212.229996,207.410004,207.699997,5207600,25958787.96,3.600314678,2756182.382,212.229996,197.580002,69.4743941,84.24560153,18679907.68,-14.05522669,66.47341943,15.410004,11.75678789,53.54405001,268003100
208.220001,209.990005,206.5,208.449997,3111100,1309705.034,4.059170858,-6233122.231,212.229996,202.490005,74.1626686,80.64043998,18698712.21,-12.71870415,67.1483532,16.270004,7.921306485,-43.03996778,271114200
208,213.449997,207.710007,213.339996,4670500,30899182.5,4.762500597,70916.18623,213.449997,202.729996,99.19176347,80.94294206,18771695.06,-0.357494266,71.21691917,20.910003,10.94700908,46.22272315,275784700
214.880005,222.25,214.419998,219.529999,5915700,54379584.09,5.753058317,10114430.94,222.25,207.699997,86.22784304,86.52742504,18907208.37,-7.302016107,75.37446189,21.380005,14.23145332,117.2892562,281700400
221.529999,223.800003,217.199997,219.740005,3782500,35454998.7,6.480326999,7282188.81,223.800003,207.699997,76.53180754,87.31713801,18912867.43,-11.85054529,75.50373992,21.050003,14.19218053,55.09040961,285482900
218.559998,219.199997,214.119995,214.679993,4045000,5946868.569,6.572626839,-3927423.359,223.800003,208.449997,47.28318833,70.01427964,18825766.79,-27.64476695,66.45164155,17.099991,8.342164774,-40.72304694,281437900
216.300003,217.5,211.679993,213.690002,4642600,4958540.853,6.491066157,-8470603.214,223.800003,213.339996,37.16591974,53.6603052,18807113.38,-30.99324924,64.81438554,11.199997,7.549448814,11.84562384,276795300
214.860001,220.330002,210.960007,216.990005,5923300,39898532.7,6.616441177,1558148.178,223.800003,213.690002,46.96261588,43.80390798,18878808.79,-22.11038096,67.67353505,14.260009,9.823870232,83.97627034,282718600
214.75,228,214.309998,226.990005,11213500,174966057.7,7.436989227,48495200.04,228,213.690002,94.07279686,59.40044416,19151784.5,-3.233018048,74.44913408,18.200012,12.09936263,195.3330348,293932100
226.419998,227.479996,221.949997,226.75,5911700,168955764.9,7.975971041,61375700.82,228,213.690002,92.66431624,77.89990966,19139928.05,-4.083632666,74.04798325,19.050003,11.84827331,69.48195293,288020400
226.929993,230.309998,225.449997,229.009995,5527900,45796448.17,8.487640485,21878332.11,230.309998,213.690002,93.28163512,93.33958274,19198849.38,-3.974329923,75.3925622,20.559998,9.684373139,17.88829413,293548300
228.970001,231.919998,228,231.279999,3979500,30603695.88,8.972878796,-1102679.19,231.919998,216.990005,96.94656835,94.29750657,19253643.3,-1.995009227,76.69844422,17.940003,11.35291398,-23.58284046,297527800
232,232,226.889999,229.869995,3660000,21784227.63,9.138317282,-13209952.88,232,226.75,87.95927214,92.72915853,19229382.19,-7.220355932,74.06906741,10.339996,10.27584471,17.6432773,293867800
229.070007,229.979996,226.679993,229.729996,3650800,20239560.65,9.152625949,-17453508.61,232,226.75,77.41290226,87.43958092,19227153.12,-8.901976471,73.79854495,9.989991,7.682572564,-21.83278022,290217000
229.059998,230.699997,225.580002,229.589996,3790200,25235349.65,9.048364923,-16013256.86,232,229.009995,63.20606265,76.19274568,19224928.28,-9.450996078,73.50941225,14.910003,4.58251585,-35.92981389,286426800
230,237.850006,229.589996,237.75,6093000,64022109.1,9.514504154,-1627070.694,237.850006,229.589996,99.18495544,79.93464012,19359638.19,-0.331804921,78.73815592,24.059998,8.196047415,61.08393919,292519800
236.699997,239.960007,234.369995,235.580002,4617500,51614340.49,9.598180302,458176.426,239.960007,229.589996,69.54100503,77.31067437,19304026,-15.10346552,74.52542368,18.589997,9.73542467,14.15327565,287902300
236.649994,239.710007,235.580002,238.360001,3769000,11215020.26,9.776123867,-11584749.5,239.960007,229.589996,88.87339747,85.86645265,19358515.54,-5.517262069,76.27658371,11.369996,11.54476053,-18.81704217,291671300
247.25,248.679993,240.75,243.759995,7732300,27722655.49,10.23489827,-10205812.58,248.679993,229.589996,78.70129906,79.03856719,19443901.41,-13.0434778,79.25908176,17.009995,12.33696916,30.54040822,299403600
245.460007,246,243.009995,244.729996,4204300,23922465.47,10.55507889,-9923052.248,248.679993,235.580002,79.30855097,82.29441583,19474670.77,-10.47189413,79.75152795,15.720001,7.815318124,-62.50679984,303607900
245.850006,250.889999,245.5,248.919998,6262900,24575690.88,11.01989203,-8697437.459,250.889999,235.580002,88.07505737,82.02830246,19546652.24,-4.933637352,81.76549146,17.639999,9.77728688,5.940761541,309870800
250,254.800003,249.649994,254.610001,4965500,43575786.17,11.71238242,-1359888.593,254.800003,238.360001,99.01143606,88.79834813,19689814.38,-0.469256549,84.08105439,24.740006,11.17855402,-10.1738454,314836300
257.309998,258.459991,251.800003,254.470001,5142600,35095526.8,12.11028934,-932802.1653,258.459991,243.759995,77.47040075,88.18563139,19687084.05,-10.92848714,83.79908496,24.740005,10.02680824,29.22728986,309693700
254.289993,255.740005,250.75,252.509995,3152100,14157145.55,12.12767702,-7335497.011,258.459991,244.729996,61.48868906,79.32350862,19647474.17,-18.02483212,79.76601442,22.919999,9.849045327,-13.87704918,306541600
251.380005,253,248.520004,252.949997,3166300,17498685.21,12.03819258,-8224700.738,258.459991,248.919998,57.48458467,65.48122483,19652966.74,-16.7578949,79.99873561,15.199997,10.10751813,-13.27106388,309707900
252.529999,255.289993,247.100006,250.630005,3801100,25246453,11.64582572,-5375566.988,258.459991,250.630005,31.07397589,50.01574987,19623926.26,-23.813834,75.09441719,15.050003,9.164166282,0.287583769,305906800
249.240005,255.889999,247.699997,251.929993,4116100,26675988.3,11.30940258,-3266472.225,258.459991,250.630005,42.51754734,43.69203597,19643642.11,-19.86009789,75.9829091,13.569992,5.964245216,-32.44542918,310022900
253.050003,253.199997,249.050003,249.240005,3958800,12395510.16,10.70235517,-6650497.208,255.889999,249.240005,24.34585557,32.64579293,19599692.36,-28.04132933,70.38730727,5.48001,5.798456102,-14.26529507,306064100
248.339996,252.419998,247.710007,251.550003,2499800,6112105.628,10.28905741,-9429545.488,255.889999,249.240005,50.62571722,39.16304004,19636383.18,-23.93484308,72.27547652,6.820007,5.533647401,-33.67471478,308563900
251.910004,252.179993,249.679993,251.330002,2186700,12002081.83,9.830444467,-7835114.131,255.889999,249.240005,48.12285971,41.0314775,19634196.9,-29.59730255,71.80588442,2.410004,3.105516555,-71.71992809,306377200
251,257.820007,250.630005,257.769989,3562500,28276014.65,9.872835635,-1292494.121,257.820007,249.240005,99.50575148,66.08477614,19690228.1,-3.015744457,76.59892086,3.159988,5.328318234,-15.2653236,309939700
258.190002,260,256.420013,257.480011,4244800,26922932.02,9.770404993,1071005.422,260,249.240005,79.49560264,75.70807128,19686220.47,-13.09085195,75.97263274,3.01001,3.438861107,-32.22309154,305694900
257.350006,263.359985,256.200012,262.079987,3933000,23934355.9,9.945759071,989616.8862,263.359985,251.330002,91.82108754,90.27414722,19762055.39,-6.289919553,78.9173995,9.569992,2.933893394,-20.79347498,309627900
266.25,271.179993,266.149994,269.200012,7820200,43196284.44,10.53778196,6995151.849,271.179993,251.330002,90.79078605,87.36915874,19868904.68,-7.710208488,82.49380746,16.250015,5.788505892,52.0670478,317448100
269.790009,270.950012,266.109985,269.230011,3619700,30780675.34,10.88392196,4865617.632,271.179993,257.480011,90.51103096,91.04096818,19869776.14,-8.097936265,82.50727196,18.600006,6.621526407,14.83455474,321067800
270.73999,280.790009,270.51001,280.600006,7029600,80805934.17,11.93808912,19469243.48,280.790009,257.480011,99.22731589,93.50971096,20022641.61,-0.563974423,86.68674178,28.670013,10.93101772,122.0130752,328097400
279.029999,287.390015,278.609985,280.980011,7345200,82844541.31,12.65827075,24322170.55,287.390015,262.079987,79.44853035,89.72895906,20032161.5,-15.90966138,86.80025409,31.740006,12.10948625,93.23879929,335442600
280,282.23999,276.440002,279.76001,4947900,26357258.48,12.9809398,6123126.131,287.390015,269.200012,64.14476389,80.94020338,20000269.02,-18.93770984,84.3147321,28.210007,11.04672638,20.20844975,330494700
277.600006,280,268.5,268.950012,7077300,10695941.61,12.22347622,-6861731.601,287.390015,268.950012,13.34597273,52.31308899,19809080.9,-45.76817791,66.22053199,17.62001,7.908043093,78.77387087,323417400
265.799988,272.890015,264.149994,272.230011,6257100,46469483.66,11.75237532,-167434.4207,287.390015,268.950012,34.76768373,37.41947345,19895392.62,-38.1960119,68.43407148,14.460022,8.221032699,150.3040243,329674500
275.450012,281.399994,274.01001,277.390015,5676700,66191932.07,11.66097322,8861687.503,287.390015,268.950012,56.97077899,35.02814515,20013993.28,-25.20160782,71.58829703,19.910004,10.36884287,159.6012256,335351200
280.309998,283.450012,272.600006,273.51001,8755000,16053341.71,11.14695724,-4203376.597,283.450012,268.950012,48.497447,46.74530324,19934590.19,-34.97984426,66.22921147,11.430023,6.106227129,145.754386,326596200
264,264.660004,255.559998,255.990005,14915200,-7850386.245,9.219600079,-16771782.02,283.450012,255.990005,1.541795569,35.67000718,19373778.38,-83.26701586,48.55412893,-13.210007,-0.578688029,251.375801,311681000
252.660004,258.25,250.199997,257,8171600,46501258.59,7.68506515,-3094989.795,283.450012,255.990005,20.45112762,23.49679006,19432625.51,-81.71551571,49.39261423,-12.230011,-1.938334574,107.77015,319852600
248.169998,248.360001,242.009995,246.229996,11460800,98818273.73,5.536069485,19427747.28,283.450012,246.229996,10.18339592,10.7254397,19090181.29,-90.70075112,41.6054932,-34.37001,-8.532695013,46.55379658,308391800
244.190002,251,243.899994,249.990005,6078100,80671320.47,4.089238051,21101404.84,283.450012,246.229996,19.25677299,16.63043217,19265191.29,-82.41514658,44.87314542,-30.990006,-7.146308069,67.91723071,314469900
254.179993,254.850006,249.110001,250.020004,4809500,36480712.73,2.911472738,5807125.482,264.660004,246.229996,35.36426409,21.60147767,19265920.67,-82.34904039,44.89963779,-29.740006,-10.89807603,-31.58216684,319279400
249.710007,253.279999,248.270004,250.479996,3351800,5863828.817,1.992237479,-10719281.45,258.25,246.229996,52.15516251,35.59206653,19274769.29,-81.33539606,45.33345568,-18.470016,-10.85487003,-54.36747808,322631200
250.740005,251.899994,249,251.570007,2919400,12704869.08,1.336287797,-14328909.53,254.850006,246.229996,74.45485833,53.99142831,19289355.28,-78.9334337,46.41017044,-20.660004,-10.07649485,-40.99719073,325550600
247.910004,251.699997,247.509995,251.210007,3355500,19193672.4,0.778420807,-12438328.18,254.850006,249.990005,66.75803643,64.45601909,19285177.58,-79.72673436,46.08730861,-26.180008,-6.59602313,-52.5878513,322195100
251.919998,253.889999,248.320007,248.589996,3459500,9665205.199,0.123470911,-13565936.45,254.850006,248.589996,14.71388803,51.97559426,19250181.17,-84.12162572,43.70436565,-24.920014,-8.683838682,-44.71080852,318735600
247,250.070007,245.320007,246.869995,3725200,906613.511,-0.528281605,-15580788.42,253.889999,246.869995,18.08622458,33.18604968,19226244.8,-88.27220558,42.1631082,-9.12001,-11.00256619,-34.37736713,315010400
247.630005,248.660004,243,244.899994,3879300,8057977.673,-1.190044692,-12713176.68,253.889999,244.899994,17.44714577,16.74908613,19196518.03,-93.02606705,40.40553408,-12.100006,-10.4603177,-55.69046259,311131100
246.210007,246.5,243,243.690002,3066300,4447534.235,-1.79148186,-11533096.91,253.889999,243.690002,6.336107102,13.95649249,19177351.34,-95.94593072,39.32133261,-2.539994,-4.804876269,-79.44177752,308064800
244.820007,246.850006,242.779999,246.169998,3022600,9395555.51,-2.04444313,-8427503.246,253.889999,243.690002,30.5130423,18.09876506,19208556.61,-89.96138684,42.71421772,-3.820007,-4.21400856,-63.01091585,311087400
246.110001,258.119995,246.020004,258,7598400,100695050.1,-1.275629799,22658942.75,258.119995,243.690002,99.21776381,45.35563774,19353811.37,-29.40397949,55.49735529,7.979996,4.780085364,-33.70096328,318685800
257,261,254.270004,255.729996,5330800,94562027.2,-0.839829021,31364804.93,261,243.690002,71.07572058,66.9355089,19286957.11,-27.75146189,53.05104767,5.25,2.296088198,-12.2949606,313355000
262.399994,265.75,259.059998,262.049988,7132200,20989208.59,0.015339943,8665414.902,265.75,243.690002,83.89198155,84.72848865,19418700.02,-15.58555695,58.53167044,10.479981,4.811608594,48.29400146,320487200
264,265.329987,261.200012,261.5,6497500,13304259.42,0.641295616,-3853675.291,265.75,246.169998,81.49760638,78.8217695,19403731.02,-18.50239362,57.89825182,10.289993,4.399554526,93.8510651,313989700
260.600006,264.549988,258.820007,261.920013,3614300,5469071.782,1.157913825,-11117801.41,265.75,255.729996,80.58799911,81.99252901,19414167.1,-16.67386519,58.2696554,13.330017,4.114165327,23.8028362,317604000
262.829987,264.799988,250.240005,250.679993,6908600,5885314.428,0.65283631,-12946339.3,265.75,250.679993,2.836802978,54.97413615,19259063.25,-65.60734151,46.45833119,3.809998,-0.210984429,105.8888392,310695400
251.559998,255.070007,250.509995,255.009995,4059300,14553299.64,0.595093844,-9759442.305,265.75,250.679993,30.75429747,38.05969985,19378395.67,-46.75665883,50.61157136,10.110001,2.58256531,17.33776557,314754700
255.389999,257.670013,253.300003,254.779999,3320200,20931566.05,0.524725064,-5539041.282,265.329987,250.679993,30.08614589,21.22574878,19374734.55,-47.75794742,50.38798823,11.089997,3.204117212,-10.8718995,311434500
255.699997,263.890015,255.009995,263.160004,5647300,48279429.55,1.132103484,5392628.548,264.799988,250.679993,88.73636048,49.85893461,19483939.72,-11.27555893,57.71726266,16.990006,7.456108798,45.57523265,317081800
260.600006,270.570007,259.75,270.220001,6230800,110596219.2,2.158258947,29202505.77,270.570007,250.679993,98.27837695,72.36696111,19635444.2,-1.259467072,62.7147949,12.220001,10.88678189,103.2025568,323312600
277.019989,280.679993,275,277.450012,7987600,80062420.68,3.514384373,26572837.31,280.679993,254.779999,89.29406293,92.10293345,19802155.6,-8.522378658,67.01446527,21.720016,12.70667192,164.2625554,331300200
278.339996,279.600006,275.540009,277.380005,3676200,19781544.59,4.531241235,3901072.611,280.679993,254.779999,87.94744629,91.83996206,19800140.14,-8.707093727,66.93397702,15.330017,7.511629845,-51.61876184,327624000
278.040009,282,277.209991,277.920013,4148400,4166023.689,5.319363446,-10696958.02,282,263.160004,84.88334107,87.3749501,19807297.03,-10.40282227,67.2606233,16.420013,8.677127184,-22.18053575,331772400
278.730011,279.679993,276.320007,278.299988,3294600,4582067.277,5.906529983,-15564051.4,282,270.220001,83.37073258,85.40050665,19812968.76,-10.28352532,67.50388109,16.379975,6.201106943,-53.80667957,335067000
286.899994,299,284.579987,298.519989,13888600,198314885.9,7.912241395,45502039.19,299,277.380005,97.99995417,88.75134261,20052339.29,-0.984436114,77.20852512,47.839996,14.15678356,113.7529819,348955600
296.890015,304.809998,294.529999,303.700012,10134600,284984917.6,9.80672093,93923900.94,304.809998,277.380005,96.20776762,92.52615146,20293339.12,-2.034059268,78.94341255,48.690017,15.95143438,180.4028443,359090200
302.040009,304.880005,294.200012,295,7880900,90854173.8,10.48522421,43425434.91,304.880005,277.920013,65.40614254,86.53795477,20003015.98,-18.08200037,69.38980523,40.220001,17.67991393,14.07376314,351209300
296.880005,301.940002,294.100006,298.700012,5520600,22127373.1,11.19248302,-3048413.685,304.880005,278.299988,78.36136753,79.99175923,20101861.49,-11.3103825,70.99732916,35.540008,17.13266847,35.99881753,356729900
297.5,302.690002,297.149994,302.540009,4579600,47673448.82,11.92537805,-13655017.32,304.880005,295,88.47293633,77.41348213,20172832.65,-4.282569546,72.60527263,32.320008,18.74558842,37.93144991,361309500
309.149994,313.730011,308.709991,312.390015,7664500,50719778.09,13.14943728,-15783430.65,313.730011,295,93.17373582,86.66934656,20321933.88,-2.119575547,76.24361402,34.940003,18.70725424,35.71972447,368974000
313.380005,313.470001,305.5,308.709991,5724600,41116605.45,13.66504374,-18274842.79,313.730011,295,74.42680223,85.35782479,20231644.36,-8.307164216,72.37611197,31.329986,14.24394562,-8.124157412,363249400
306.339996,308.450012,296.320007,296.839996,6050700,12311928.45,12.96638774,-26797832,313.730011,296.839996,13.95817271,60.51957025,20011531.72,-28.76364169,61.53372606,18.919983,6.988640534,-24.2488357,357198700
296.700012,307.390015,295.299988,304,9284600,75527730.34,12.84241098,-7734224.077,313.730011,296.839996,47.20564917,45.1968747,20157479.15,-18.02521122,64.94507444,25.700012,9.596940847,152.5597084,366483300
302.700012,304,298.679993,301.440002,4138700,87604050.05,12.39470957,4610101.262,313.730011,296.839996,33.31528127,31.49303438,20079293.11,-31.73252133,62.8006004,2.920013,8.462862658,-0.233825089,362344600
299.700012,300.839996,297.899994,300.25,3035700,15956011.19,11.80776717,-13556150.85,313.470001,296.839996,27.24275431,35.92122825,20062954.66,-35.29722517,61.77939992,-3.450012,7.887176768,-7.858313604,359308900
302.459991,306.619995,302.109985,305.519989,3898000,18866173.46,11.63374854,-18829461.37,308.450012,296.839996,77.71849694,46.09217751,20116237.28,-21.9460602,64.53016253,10.519989,2.344901601,-71.93381622,363206900
306.51001,309.149994,300.230011,302.51001,6149400,21784508.69,11.12471855,-18346394.34,309.149994,300.25,52.05789803,52.33971643,20077834.23,-29.99198022,61.79461248,3.809998,-0.39183469,-39.32271624,357057500
302,306.399994,300.420013,305.600006,4509800,32200469.73,10.84562387,-13166752.56,309.149994,300.25,68.44455111,66.07364869,20140647.43,-27.89021717,63.50499959,3.059997,3.593222373,-42.77557132,361567300
309.220001,310.549988,306.019989,308.029999,5083500,30147412.11,10.69720868,-10504076.29,310.549988,300.25,80.07912889,66.86052601,20176507.32,-29.03724171,64.83813272,-4.360016,3.123530842,-7.91761765,366650800
308,313.980011,305.859985,313.790009,6737700,60662456.28,10.91851144,1249448.622,313.980011,302.51001,98.61816727,82.38061576,20271566.28,-0.955744226,67.83726753,5.080018,3.718516449,47.12420299,373388500
312.369995,314.5,309,310.170013,4695000,55069442.69,10.67869471,4164527.343,314.5,302.51001,69.65668999,82.78466205,20193837.71,-21.22543271,64.1348316,13.330017,-0.710650755,-38.74355796,368693500
311.690002,313.089996,307.5,308.630005,3468600,2949081.636,10.24625994,-11605285.09,314.5,305.600006,58.30965611,75.52817113,20170526.83,-30.57287152,62.5702906,4.630005,-0.025909754,-39.408867,365224900
309.829987,314.799988,308,314.070007,4505500,28016854.56,10.22465154,-9025436.513,314.799988,308.029999,91.83466717,73.26700442,20231665.38,-3.743492308,65.74884049,12.630005,5.804477575,-25.53754111,369730400
314.880005,327.25,314.809998,322.829987,8829600,94540830.6,10.79000347,14017169.97,327.25,308.630005,79.3360921,76.49347179,20357331.91,-13.8341513,70.14539662,22.579987,6.194074671,-4.900588071,378560000
324,327.660004,316.559998,318.890015,5382800,75965207.21,10.79568025,16258977,327.660004,308.630005,56.49807907,75.88961278,20249571.24,-27.10131231,66.03943045,13.370026,5.788884317,30.06016382,373177200
317.670013,321.529999,310.450012,311.019989,7133400,5588556.697,10.04929183,-6694579.564,327.660004,308.630005,17.46025943,51.09814353,20116726.77,-51.42152896,58.65391347,8.509979,3.587007161,134.983694,366043800
307.440002,307.769989,290.76001,295.459991,14152000,53571862.21,8.108739332,-208657.3529,327.660004,295.459991,12.73707795,28.89847215,19759850.38,-87.26292205,47.37337228,-10.140015,-3.292746256,263.0579785,351891800
298,308.549988,296.799988,308.350006,8177300,150581218.3,7.524219463,33330256.63,327.660004,295.459991,47.6693736,25.95557033,20377258.82,-52.3306264,55.08055859,0.320007,1.930513308,32.97720103,360069100
310.899994,313.790009,305.820007,307.190002,7006500,98105531.45,6.887980279,27323888.64,327.660004,295.459991,44.52573082,34.97739412,20346496.05,-55.47426918,54.30972844,-6.600007,0.520286639,55.36165684,353062600
309.380005,321.98999,309.100006,321.26001,9676500,120915028.2,7.433400584,29640315.36,321.98999,295.459991,97.66256655,63.28589032,20667409.85,-17.34416,61.37114368,11.089997,4.295039783,90.35113603,362739100
321.559998,325.5,318.119995,325.220001,5741600,157665840.2,8.091909785,39586810.55,325.5,295.459991,99.19401531,80.46077089,20786686.61,-6.61247533,63.09969586,16.589996,3.642560844,-14.78397673,368480700
323.399994,326,319.600006,323.100006,4753800,55031793.71,8.346503891,7400742.824,326,307.190002,90.06851778,95.64169988,20749259.14,-12.35772017,61.51275357,9.029999,4.168679259,1.252396166,363726900
325.480011,327,321.529999,324.809998,4121600,26352932.5,8.587264973,-15564171.89,327,307.190002,89.6600438,92.9741923,20774418.41,-7.723594752,62.33558156,1.980011,5.242521057,18.82603932,367848500
318.380005,320.200012,312.529999,315.880005,7622000,33109476.94,7.965670766,-21394175.41,327,315.880005,37.87710208,72.53522122,20661103.36,-31.92412172,55.645052,-3.01001,0.576303996,69.17101321,360226500
317.589996,320.059998,315.140015,317.01001,4152500,26431724.33,7.478032732,-23958991.28,327,315.880005,30.96068203,52.8326093,20688369.72,-28.86177705,56.28445447,5.990021,-1.802799379,-52.9706895,364379000
314.390015,314.630005,305.5,306.109985,6711900,3021630.318,6.141242732,-30278810.3,327,306.109985,2.837139535,23.89164122,20545590.78,-58.401145,48.95368683,10.649994,-4.00766076,24.69161031,357667100
307,313.940002,305.309998,313.059998,5653800,41071117.63,5.578331458,-18004916.64,327,306.109985,35.7307482,23.17618992,20697979.77,-39.56641836,53.14419953,4.709992,0.655909289,-20.74186223,363320900
315.5,316.5,310.200012,310.829987,4687600,41974643.48,4.895840763,-11059482.22,320.200012,306.109985,37.07175158,25.21321311,20657706.23,-45.60980958,51.67825777,3.639985,5.202056613,-66.87676653,358633300
312.799988,314.369995,306.799988,310.350006,4329200,11803965.52,4.26704369,-16812521.83,320.059998,306.109985,34.16954576,35.65734851,20650467.68,-45.94370473,51.3499339,-10.910004,0.648613576,-47.05831998,354304100
310.459991,310.730011,303.480011,303.859985,4318400,10618560.38,3.20804666,-18014801.32,316.5,303.859985,2.918389562,24.71989563,20559935.7,-63.85215614,47.00168164,-21.360016,-1.084025189,-38.36580318,349985700
306.51001,311,305.399994,310.220001,5033300,21108284.06,2.8491409,-13531294.37,316.5,303.859985,51.76647999,29.61813844,20650323.03,-55.56288852,51.34938556,-12.880005,-3.436471598,-47.98429184,355019000
311.019989,316.970001,307.809998,316.829987,5014000,68709060.12,3.062770416,4678686.707,316.970001,303.859985,98.96208967,51.21565307,20757569.64,-43.23987141,55.44070335,-7.980011,-2.579796438,-12.6724258,360033000
317.279999,325.48999,316.309998,325.140015,7802200,113745694.1,3.858148819,26032727.37,325.48999,303.859985,98.40992579,83.04616515,20889080.17,-7.908103188,59.99551289,9.26001,0.631386246,64.12554167,367835200
326,336.279999,325.76001,335.100006,7782900,140415382.4,5.231870225,40887669.59,336.279999,303.859985,96.40245905,97.92482484,21128084.41,-3.59754095,64.65844119,18.089996,3.168008394,88.83200699,375618100
337.690002,342.890015,335.160004,341.01001,9963400,127682037.7,6.719978537,39196111.76,342.890015,310.220001,94.98531889,96.59923458,21265347.82,-4.770375055,67.10834624,34.900025,7.955554199,30.7189714,385581500
344,344.880005,337.290009,340.369995,7608000,74774590.84,7.758239084,18106640.32,344.880005,316.829987,87.83380321,93.07386039,21246648.3,-10.89374554,66.57016292,27.309997,7.368847753,83.21493076,377973500
339.769989,342.880005,335.929993,339.850006,5590200,38388320.78,8.441797494,-3744378.502,344.880005,325.140015,82.39412752,88.40441654,21235025.43,-12.1497578,66.10630469,29.020019,11.02218897,-16.71210834,372383300
338.5,348.440002,334.209991,347.320007,6784400,107886111.2,9.47704365,9769899.711,348.440002,335.100006,95.0617487,88.42989314,21357899.63,-2.491092581,69.40448641,36.970001,10.94359203,19.99717004,379167700
344.700012,359.48999,339.970001,352.850006,11086800,227436332.8,10.62127297,52449002.22,359.48999,339.850006,73.73423947,83.73003856,21465920.26,-11.85500177,71.60717612,48.990021,13.51865031,136.5133544,390254500
356.339996,360.5,355.140015,359.649994,9398000,179921130.4,11.93915797,50022070.47,360.5,339.850006,96.76680978,88.52093265,21679580.76,-1.490715826,74.07846788,49.429993,15.88528663,117.0839878,399652500
363.75,371.899994,360.220001,370,9061500,128041832.8,13.66127167,27974724.58,371.899994,339.850006,94.95889135,88.48664687,21950036.36,-2.77695772,77.31494412,53.170013,21.76660905,109.834661,408714000
374.420013,376.869995,354.799988,357.320007,17261400,115356033.3,13.84331263,12375808.26,376.869995,347.320007,54.17255938,81.96608684,21639496.48,-26.63849607,66.38009659,32.179992,15.1827754,242.943993,391452600
357.98999,364.5,350.619995,359.01001,10517700,112292184.8,13.96299383,3894499.064,376.869995,352.850006,51.59894877,66.91013317,21721137.07,-24.33572543,67.04901151,23.910004,13.31314103,109.7666534,401970300
367.619995,376,366.609985,375.950012,11807900,194306816.1,15.2489779,26166391.68,376.869995,357.320007,96.49530286,67.42227034,22217418.11,-1.287229589,72.87483663,34.940002,15.62711283,51.34064751,413778200
381.089996,384.25,376.309998,380.660004,12818400,160187645,16.45846361,22042757.73,384.25,357.320007,89.32502092,79.13975751,22365350.31,-4.696488626,74.23863231,40.290009,13.59594067,64.69953359,426596600
372.5,375.459991,366.48999,375.339996,10426500,142099508.3,16.79411743,12596613.27,384.25,357.320007,73.50579044,86.44203807,22186203.59,-13.11451831,69.96001318,35.48999,10.06714906,4.648011723,416170100
377.980011,378.01001,370.100006,371.399994,6731000,95260549.51,16.55140596,-7316170.286,384.25,359.01001,61.79005623,74.87362253,22076755.01,-21.96958146,66.88551269,24.079987,9.116549477,-11.52733964,409439100
375,376.700012,367.799988,369.799988,6549300,11146489.91,16.04499159,-41560767.04,384.25,369.799988,18.63736563,51.31107077,22047757.59,-28.87691727,65.62426898,16.949982,8.812706038,17.15681013,402889800
376.670013,378.880005,369.730011,372.23999,7438700,21293875.31,15.66002332,-48562955.18,384.25,369.799988,32.3761079,37.60117659,22090970.97,-24.00081503,66.65685622,12.589996,7.174934498,9.644183716,410328500
374.350006,376.98999,368.019989,376.399994,4923200,54205446.8,15.51180037,-36540808.92,378.880005,369.799988,79.9837934,43.66575564,22174102.88,-15.68745921,68.39968405,6.399994,6.67422066,-55.59403976,415251700
377.98999,385,373.570007,382.609985,7529800,107427363.2,15.71428252,-11366520.33,385,369.799988,86.10457365,66.15482498,22255327.71,-4.705679418,70.84920027,25.289978,6.383982033,-19.8786976,422781500
382.450012,386.98999,379.350006,383.450012,6445800,89935907.37,15.76085294,-5600090.919,386.98999,369.799988,81.5530087,82.54712525,22271859.52,-7.528666159,71.1746993,24.440002,3.635138378,-28.86608177,429227300
386.690002,386.950012,373.100006,377.48999,6604100,47922234.41,15.14228552,-16099984.74,386.98999,372.23999,49.92093042,72.52617092,22171671.47,-26.12043252,65.57960604,1.539978,5.644795311,-61.74064676,422623200
376.399994,376.399994,362.019989,362.369995,6996400,20103742.66,13.27893783,-27783099.16,386.98999,362.369995,1.401705991,44.2918817,21907150.66,-67.69314926,53.98527985,-18.290009,0.935902874,-33.47975318,415626800
366.679993,371.73999,362.519989,371.23999,6302500,50238694.91,12.37530106,-20448424.87,386.98999,362.369995,36.9243117,29.41564937,22078406.65,-43.30492759,58.60849725,-4.100006,-1.252831986,-46.62471735,421929300
370.609985,371,354.100006,360.75,8221000,104299511.6,10.68948614,1612240.363,386.98999,360.75,20.21890312,19.5149736,21900319.26,-72.14735663,51.95959877,-10.649994,-5.23039032,-35.86563066,413708300
363.709991,366.769989,359.619995,361.609985,5848500,57101203.47,9.315476257,-4527152.844,386.950012,360.75,22.86142353,26.66821278,21919917.14,-77.16636469,52.43599467,-8.190003,-3.658019701,-43.90735146,419556800
370.23999,371.350006,351.5,352.619995,6305400,8530099.494,7.415663318,-22081605.62,376.399994,352.619995,4.497972971,15.8594332,21774517.52,-96.84419466,47.17000141,-19.619995,-5.056542623,-6.322983212,413251400
347.200012,347.23999,326.329987,327.089996,17046700,-2359078.326,3.806115786,-30720292.37,371.73999,327.089996,1.673659876,9.677685458,21318000.99,-98.74710029,36.08660069,-49.309998,-11.54948442,160.2827783,396204700
317.26001,320.790009,306.299988,308.829987,19324500,29469114.72,-0.521890728,-21334394.4,371.350006,308.829987,3.889313297,3.353648715,20366358.02,-96.86454463,30.55636427,-73.779998,-17.03471005,159.7832955,376880200
313.5,317,307.380005,313.220001,14176900,110163067.3,-3.556631002,10120130.08,371.350006,308.829987,10.63798783,5.400320335,20641055.52,-91.42395238,33.2065787,-70.230011,-16.78533316,187.9610822,391057100
312.899994,317.940002,303.130005,316.049988,13820900,254024493.9,-5.667991161,67841968.55,371.350006,308.829987,18.93870245,11.15533453,20769145.81,-84.59338742,34.9305457,-61.440002,-17.39630423,83.54936386,404878000
316,327.279999,314.299988,327.220001,11559400,326096171.9,-6.366543055,108219893.8,347.23999,308.829987,54.61347584,28.06338871,21257611.69,-71.27355079,41.36359014,-35.149994,-14.66423503,79.33227838,416437400
330.399994,333.100006,324.5,329.519989,10346100,196924592.7,-6.657813524,73799915.83,333.100006,308.829987,88.05466506,53.86894778,21338861.25,-68.53089826,42.62148761,-41.720001,-12.707622,56.66177072,426783500
330.109985,331.600006,319.970001,323.410004,8594500,71143172.06,-7.297550575,12988571.4,333.100006,313.220001,67.66766207,70.11193432,21147023.06,-75.81683445,40.15693716,-37.339996,-10.75143956,22.84174718,418189000
323.190002,328.420013,321.220001,327.779999,5625200,59914019.07,-7.367002503,-16642488.31,333.100006,316.049988,82.24889282,79.32373998,21263154.05,-70.59175383,42.70860413,-33.829986,-11.70671053,-10.74652916,423814200
325.540009,327.100006,313.450012,319.570007,9876900,91399274.21,-7.992390099,-17233296.26,333.100006,319.570007,31.14502223,60.35385904,21122258.18,-77.56243419,39.31677085,-33.049988,-11.41510547,20.14231845,413937300
317.5,329.130005,315.660004,328.23999,6373700,134757923.1,-7.699662191,-2112393.377,333.100006,319.570007,75.2670866,62.88700055,21390219.98,-63.40185033,44.34360321,1.149994,-9.228173,8.980080362,420311000
328.230011,331.649994,323.220001,325.26001,6357000,87909615.82,-7.620290729,-10640813.31,331.649994,319.570007,64.89016308,57.1007573,21332355.31,-67.56082575,43.02437457,16.430023,-7.759056601,0.818346179,413954000
326.899994,330.220001,324.200012,329.920013,5166200,37442921.2,-7.099526059,-29219950.36,331.649994,319.570007,90.49460049,76.88395005,21423432.11,-60.72998005,45.74271998,16.700012,0.865210503,-69.69384104,419120200
329.459991,331.26001,325.799988,328.399994,4901600,39469907.8,-6.731868349,-33519197.02,331.649994,319.570007,82.14283948,79.17586768,21399630.21,-62.95809348,44.98872795,12.350006,6.336822143,-74.63530751,414218600
330.23999,343.399994,330.01001,342.519989,8637100,117658980.2,-5.24071962,-7352438.794,343.399994,325.26001,96.82766648,89.82170215,21610381.03,-10.70052733,52.77588308,15.299988,9.354443492,-39.07624375,422855700
345,345.600006,334.149994,339.600006,6989200,141911064.4,-4.245650518,11737119.89,345.600006,325.26001,73.19035452,84.05362016,21536749.75,-14.12761916,51.16296141,10.080017,7.451358612,-49.43021077,415866500
340.359985,345.5,338.119995,343.850006,4820800,60974185.37,-3.078623152,-7273169.425,345.600006,328.399994,91.82242761,87.28014954,21624217.65,-4.120555589,53.39549969,20.440002,5.082209202,-58.29541326,420687300
346,347.5,326.290009,334.459991,8302400,89271521.88,-2.878262474,-5385210.761,347.5,328.399994,39.90782586,68.30686933,21492569.02,-29.38925055,48.15739016,6.679992,1.499150936,-19.75333701,412384900
336.890015,339.600006,332.51001,335.070007,4880400,72101685.08,-2.639821778,-9586429.31,347.5,334.459991,41.39557626,57.70860991,21507711.62,-36.50513181,48.51077337,15.5,3.605331578,-43.2148467,417265300
335.5,341.48999,321.040009,323.470001,8535100,22594901.33,-3.348282432,-26185774.52,347.5,323.470001,9.183646359,30.16234949,21338753.89,-70.57270916,42.56854266,-4.769989,-1.314905733,51.72971628,408730200
323,324.450012,316.130005,319.570007,8303100,36911909.79,-4.176297765,-26040479,347.5,319.570007,10.9658991,20.51504057,21235848.4,-82.02644007,40.76076887,-5.690003,0,-15.93414938,400427100
318.940002,327.119995,311.220001,325.890015,13091500,214732357.9,-4.273274408,32965509.84,347.5,319.570007,40.43554136,20.19502894,21400055.48,-59.56445864,44.84822558,-4.029998,-0.715931962,105.398748,413518600
345.329987,350,343.149994,347.089996,13535000,238617784.8,-2.6093884,61707367.48,350,319.570007,92.49612152,47.96585399,22251691.12,-7.503878481,55.85231713,18.690002,6.711549323,112.914897,427053600
347,357.269989,343.299988,356.910004,9268900,173489051.4,-0.492674924,47132860.66,357.269989,319.570007,99.21827341,77.3833121,22634628.72,-0.781726588,59.84860193,14.390015,8.180768046,79.41426968,436322500
357.350006,359.480011,352.75,355.170013,6324500,137166101.7,1.032530653,25328454.74,359.480011,319.570007,91.06921445,94.26120313,22589441.41,-8.930785551,58.8323887,15.570007,8.151650271,29.02929656,429998000
357.529999,368.579987,357.399994,365.220001,7449800,67273627.4,3.017434,-8132630.859,368.579987,325.890015,94.14228239,94.80992342,22768401.19,-5.857717608,62.76503598,21.369995,6.627353944,-13.74651214,437447800
361,370,358.950012,363.529999,6892100,83548816.48,4.403356019,-15903457.45,370,347.089996,75.9031674,87.03822141,22733928.34,-11.00714718,61.69769151,29.070008,7.046523138,-1.389286327,430555700
361.600006,366.649994,354.660004,355.399994,7092900,26123788.33,4.790464255,-35908262.97,370,355.170013,45.31835416,71.78793465,22579793.03,-24.83839103,56.70223404,20.329987,3.359019281,47.13118155,423462800
356.970001,361.26001,353.619995,357.869995,4365800,15210994.16,5.236199116,-44299912.2,370,355.170013,29.68113043,50.300884,22629088.11,-20.6362797,57.8196316,34.399994,6.999343608,-47.41520524,427828600
364.630005,367.660004,362.600006,363.799988,4519200,18592954.38,5.998797675,-42629516.61,370,355.399994,62.14890044,45.71612835,22701430.48,-10.54782597,60.45804079,44.229981,8.574321903,-7.401032702,432347800
365.200012,365.48999,359.369995,362.329987,3085100,9514398.412,6.410647775,-40959393.81,370,355.399994,53.1745381,48.33485633,22683169.81,-13.04867834,59.46505791,36.439972,12.01347447,-63.85396773,429262700
363,366.5,362.519989,362.910004,3413800,5791071.614,6.706535702,-37737275.38,367.660004,355.399994,66.16811286,60.4971838,22688108.44,-12.06191923,59.7459921,15.820008,13.56197267,-58.88523563,432676500
361.209991,363.299988,351.589996,351.920013,5027700,-4974617.07,5.985234531,-36413921.03,367.660004,351.920013,2.053620633,40.46542386,22584728.45,-30.75873989,52.34348295,-4.989991,7.987356716,-61.59569186,427648800
352.910004,354,345.799988,347.459991,5408200,1437479.023,4.996119499,-30521979.94,367.660004,347.459991,7.593786757,25.27184008,22521010.41,-38.34639228,49.65470505,-7.710022,0.106599154,-60.04285187,422240600
345.820007,345.820007,331.850006,337.859985,6495400,40000437.33,3.398423546,-13066882.77,366.5,337.859985,17.34481974,8.997409044,22371586.73,-54.67848851,44.37130278,-27.360016,-5.337485301,-29.92264454,415745200
341.130005,342.23999,337.369995,341.350006,4322000,51747946.77,2.386345217,-1000418.853,366.5,337.859985,27.41703216,17.45187955,22438682.81,-75.09829228,46.59598705,-22.179993,-3.891096234,-31.66258202,420067200
338.98999,353.48999,338.299988,352.769989,4954500,87868547.09,2.477207333,15519727.29,363.299988,337.859985,66.51826701,37.09337297,22583276.82,-45.16386294,53.19240178,-2.630005,-3.408907498,-33.49485892,425021700
352.519989,356.660004,349.73999,352.929993,4584700,83610749.98,2.53292917,19512330.97,356.660004,337.859985,84.96569407,59.63366441,22585524.01,-44.74445527,53.27947645,-4.940002,-2.915854545,-33.47891064,429606400
354.23999,355.690002,347.299988,348.049988,3484000,11594413.34,2.158432441,-3542468.362,356.660004,337.859985,65.29618422,72.26004843,22522130.82,-57.53608244,50.21149498,-15.75,-2.068094014,-50.88045792,426122400
347.279999,347.350006,339.720001,345.660004,3764000,20964908.72,1.649771808,-9670413.342,356.660004,341.350006,42.97566165,64.41251332,22498206.94,-63.80078592,48.73149427,-16.669983,-3.411850999,-13.78441523,422358400
339.480011,349.049988,338.75,347.359985,4073700,55930557.78,1.368058722,-172737.6495,356.660004,345.660004,49.34634589,52.53939725,22516718.57,-56.68813218,49.86349469,-15.550019,-4.518967439,-9.857939458,426432100
349.670013,353.470001,347,353.179993,3412900,55344810.76,1.596027071,3542004.506,356.660004,345.660004,80.56945716,57.63048823,22584973.31,-40.43566548,53.63769659,1.25998,-2.525320655,10.62526336,429845000
353.549988,358.440002,352.820007,355.899994,4072800,31642151.98,1.973426546,-2802083.725,358.440002,345.660004,87.10001147,72.33860484,22611257.62,-32.84001859,55.33014627,8.440003,-1.931611122,19.30400141,433917800
356.119995,357.589996,353.690002,355.399994,3049500,14205636.81,2.206734664,-10690639.76,358.440002,345.660004,84.56065164,84.07670676,22605535.79,-32.0346549,54.9331641,17.540009,0.988855669,-39.34602303,430868300
353.799988,355.48999,345.890015,349.589996,3835100,15335009.72,1.900902327,-12586554.06,358.440002,347.359985,55.05330065,75.57132126,22555683.26,-48.8023288,50.4073787,8.23999,0.613021659,-29.08731186,427033200
349.5,350.980011,341.559998,344.529999,4091400,21182829.29,1.235980908,-10357253.31,358.440002,344.529999,17.59478848,52.40291359,22500173.67,-59.68203416,46.7917209,-8.23999,1.974194724,-37.01080765,422941800
345.980011,352.480011,343.450012,350.609985,4239200,38824684.41,1.185958955,-2890380.617,358.440002,344.529999,53.61365436,42.08724783,22572375.38,-29.44722895,51.31092289,-2.320008,2.712751966,-1.915779732,427181000
348.98999,349.779999,342.299988,343.399994,3263500,30280957.93,0.558096786,-2291447.43,357.589996,343.399994,11.47845433,27.56229906,22485199.9,-56.56265612,46.28996876,-4.649994,-2.656120218,-34.13058835,423917500
351.350006,363.709991,350,363.690002,7667100,105757733.8,1.678398041,22177221.86,363.709991,343.399994,99.90975618,55.00062162,22678025.88,-0.075888394,58.57488783,18.029998,3.048765821,67.23231618,431584600
364.48999,368.76001,360.399994,362.75,5972900,114693872.8,2.462013987,33014337.9,368.76001,343.399994,77.90438475,63.09753175,22658209.31,-19.73081306,57.91399407,15.390015,4.223534695,71.4380023,425611700
363.820007,368.070007,359.589996,366.230011,4185200,36624121.45,3.32550868,9606024.69,368.76001,343.399994,90.43840931,89.41751675,22715509.82,-8.430517017,59.72568805,13.050018,5.9509364,11.19022317,429796900
364.329987,377.959991,362.630005,377.640015,7202500,134840946.9,4.874338075,30407429.69,377.959991,343.399994,99.10270338,89.14849915,22845900.96,-0.816057316,65.03958971,21.740021,8.717190036,76.80487027,436999400
374.51001,380,372.700012,379.809998,5420500,146357858.3,6.205364444,39817255.39,380,362.75,99.36666,96.3025909,22887287.73,-0.460610909,65.95948156,24.410004,7.540066121,58.82387412,442419900
380.25,389.609985,377.679993,385,7188000,88237220.76,7.591492221,21554048.92,389.609985,362.75,84.64361529,94.37099289,22961357.41,-9.064070703,68.12007668,35.410004,8.176455884,76.48791986,449607900
380,382.390015,373.570007,375.100006,6451900,54377330.81,7.801233924,1349676.84,389.609985,366.230011,51.66560854,78.55862794,22776523.24,-30.19767518,60.26269475,30.570007,5.543053554,111.5723889,443156000
373,378.25,371.070007,373.910004,4919100,15535551.46,7.781729584,-19397193.97,389.609985,373.910004,41.80877451,59.37266611,22756054.63,-32.6742669,59.37612677,23.300019,6.956723098,28.26523428,438236900
374.899994,376.829987,364.51001,366.480011,4618200,16214968.07,7.085061732,-25904990.93,389.609985,366.480011,7.848617379,33.77433347,22658306.84,-48.13731583,54.03129244,23.080017,6.371001673,12.87578824,433618700
366.48999,369.899994,350.880005,351.089996,8159400,-1137792.684,5.230804393,-31733605.3,389.609985,351.089996,0.542192379,16.73319475,22464369.48,-80.16649203,44.99618364,-12.600006,0.136907396,92.47499528,425459300
353.149994,357.470001,342.880005,344.98999,7605900,3186474.397,3.231818199,-29857262.07,382.390015,344.98999,5.34038083,4.577063529,22322604.15,-92.86161722,41.99842324,-17.76001,0.463015733,133.0595986,417853400
350.929993,351.23999,340.899994,345.25,7156300,36526671.99,1.649572627,-15767125.88,378.25,344.98999,11.64660054,5.843057916,22328336.52,-91.0695816,42.17526278,-20.980011,-5.07025266,-6.662232135,425009700
349.899994,351.48999,340.5,340.970001,6060300,24031505.92,0.049698567,-12545338.83,376.829987,340.970001,1.293699885,6.093560418,22239621.22,-99.04296244,40.01266688,-36.670014,-6.004134804,1.463275796,418949400
339.880005,342.75,335.399994,339.600006,5319600,17109785.02,-1.313617731,-12289215.43,369.899994,339.600006,12.17394783,8.371416083,22215271.33,-92.25232854,39.31769752,-40.209992,-7.27138798,27.1050368,413629800
341.859985,344.679993,338.600006,341.100006,5107100,29823174.84,-2.247114914,-7022066.788,357.470001,339.600006,25.82696054,13.09820275,22238767.8,-89.48531093,40.53551658,-43.899994,-9.675883791,-29.09267615,418736900
342.519989,343.700012,335.51001,341.529999,5286800,40186307.1,-2.918577767,-931594.1884,351.48999,339.600006,38.09823818,25.36638219,22245205.84,-88.69211212,40.90165965,-33.570007,-10.07872336,-2.466562125,424023700
335.899994,348.549988,331.279999,348.140015,10153600,201374515.4,-2.884097783,52931810.37,351.48999,339.600006,83.42416382,49.11645418,22347527.26,-71.0954568,46.3685288,-25.769989,-9.574022078,41.25765164,434177300
351.25,358.619995,349.600006,355.01001,8163500,211846188.9,-2.27618255,73486752.83,358.619995,339.600006,86.79595637,69.43945279,22547892.56,-59.31764667,51.40045424,-11.470001,-5.35590394,26.52861948,442340800
356,357.440002,351.350006,355.329987,4171700,56055275.35,-1.748431054,25645142.92,358.619995,341.100006,87.96631865,86.06214628,22555250.48,-58.7690832,51.62809744,4.239991,-4.969114707,-15.19383627,446512500
353.100006,360.100006,352.25,356.880005,4297500,33292559.3,-1.191377237,-3500483.784,360.100006,341.529999,88.82720257,87.8631592,22573448.24,-49.91195855,52.78190556,11.890015,-2.619516948,-6.944263999,450810000
349.649994,351.75,342.670013,342.940002,7493700,12886989.21,-1.853385144,-21598150.3,360.100006,342.940002,40.45801585,72.41717902,22405584.63,-75.17563817,42.87653159,-2.309998,-2.321340423,-8.158688139,443316300
346.799988,355.630005,345.529999,355.589996,6978500,64928383.34,-1.341814779,-10479647.54,360.100006,342.940002,74.12500395,67.80340746,22682004.01,-46.63006936,51.72934204,14.619995,3.072554656,-8.248859438,450294800
353.890015,357.600006,351.149994,354.600006,4500800,83610467.79,-1.004694012,965825.6994,360.100006,342.940002,68.44519674,61.00940551,22662575.32,-39.61675293,51.06239258,15,2.708184214,-37.10716432,445794000
352.950012,359.779999,352.640015,355.679993,4087000,23511927.2,-0.64296574,-13562000.5,360.100006,342.940002,74.64133807,72.40384625,22676283.18,-15.33661321,51.79259312,14.579987,4.314160177,-32.56109434,449881000
356.980011,358.48999,353.679993,355.570007,3540500,14619783.98,-0.361006967,-21101611.29,359.779999,342.940002,75.39453276,72.82702252,22675019.37,-15.71824393,51.70797555,14.040008,4.702591495,-33.44424393,446340500
353.76001,354.480011,347.160004,350.600006,5375500,20184700.4,-0.532452373,-20497014,359.779999,350.600006,35.57899649,61.87162244,22625531.82,-32.96321198,47.89969156,2.459991,2.785106958,5.255428717,440965000
350.910004,356.220001,350.070007,355.75,3293300,34096658.14,-0.249882131,-13959781.83,359.779999,350.600006,68.06655629,59.68002851,22704493,-15.09370209,51.85649459,0.73999,4.163616971,-37.70711962,444258300
355.970001,363,354.130005,359.649994,4939100,43852623.09,0.285463103,-6912217.831,363,350.600006,78.85096688,60.83217322,22740596.59,-10.56117873,54.66441784,4.320007,3.306135033,-51.35616924,449197400
355.559998,357.149994,348.200012,351.809998,5061800,40651296.27,0.076227203,-4419344.02,363,350.600006,29.35603014,58.7578511,22632929.34,-35.27743268,48.53600346,-5.070007,-0.901386414,-37.99473265,444135600
352.690002,354.549988,344.339996,345.100006,4930400,14436672,-0.623842762,-11338790.27,363,345.100006,4.07293589,37.4266443,22536386.78,-56.43125295,43.99039427,2.160004,-2.879008633,18.18683031,439205200
349.880005,349.950012,336.25,337.019989,5747300,-1815161.937,-1.809781067,-18309711.78,363,337.019989,2.878463551,12.10247653,22420948.61,-97.12153645,39.22629965,-18.570007,-5.564900169,33.73589296,433457900
338.799988,342.799988,336.160004,337.339996,4491700,607766.6861,-2.6927831,-18726001.32,363,337.019989,4.396394098,3.782597846,22426405.78,-95.6036059,39.50572685,-17.26001,-1.632940447,-40.06031733,437949600
336.700012,337.5,323.559998,325.839996,8594100,14012754.47,-4.271285741,-12928714.44,357.149994,325.839996,6.787729299,4.687528983,22273282.67,-94.2190723,33.53795026,-29.839997,-8.366377101,23.15110697,429355500
327.779999,330.230011,323.200012,326.170013,5023500,24424668.84,-5.43300257,-6068877.557,354.549988,325.839996,9.473694653,6.88593935,22281986.94,-92.53768368,33.84678533,-29.399994,-8.01748238,11.61349093,434379000
319.75,324.589996,316.660004,320.869995,6979700,38128864.9,-6.704058473,1649561.51,349.950012,320.869995,12.6464103,9.63594475,22200358.83,-90.9149949,31.32896551,-29.730011,-9.78688672,70.77807683,427399300
319.179993,323.779999,317.25,320.079987,4254400,35739539.17,-7.686521046,3896904.624,342.799988,320.079987,13.08334007,11.73448167,22183174.24,-92.61980299,30.95927624,-35.670013,-9.981162444,20.16381867,423144900
320.230011,331.950012,320.179993,331.529999,5672300,73807502.08,-7.455269729,16574541.86,337.5,320.079987,71.35315669,32.36096902,22335364.11,-67.91109995,41.69759724,-28.119995,-5.439248909,5.521346851,428817200
332.25,332.609985,320.26001,321.079987,8457300,63217237.27,-8.022748774,16884441.75,332.609985,320.079987,27.71152517,37.38267398,22156570.02,-90.46183992,36.16846856,-30.730011,-9.745611525,156.8032065,420359900
300.130005,308.690002,292.630005,299.26001,19791400,118635125.1,-10.11655247,33109234.05,332.609985,299.26001,16.58331245,38.54933144,21581828.22,-90.57836369,27.86106124,-45.839996,-16.79132073,300.7086311,400568500
299.5,306.25,295.130005,306.089996,8894000,216946296.4,-11.09686643,68017545.94,332.609985,299.26001,33.66682775,25.98722179,22033525.67,-80.87254234,33.04509688,-30.929993,-12.9956517,75.70824608,409462500
307,307.5,299.01001,302.779999,6486000,118196449.3,-12.002504,44694399.81,332.609985,299.26001,25.38769154,25.21261058,21937347.71,-85.57624738,31.85053824,-34.559997,-12.26311396,31.5511926,402976500
301.019989,306.5,300.029999,306.049988,5294300,52349653.81,-12.31441462,10138732.4,332.609985,299.26001,33.56675766,30.87375898,22007395.76,-79.20027079,34.3744646,-19.790008,-9.189366213,-7.881961965,408270800
305.5,306.890015,301.299988,304.390015,4725300,43991422.17,-12.55087332,-7578817.281,308.690002,299.26001,73.22548068,44.05997663,21978680.2,-81.00773057,33.69230748,-21.779998,-9.767588009,5.20070352,403545500
302.5,304.459991,296.299988,302.98999,5447100,47947862.69,-12.704786,-12879054.96,307.5,302.779999,63.540729,56.77765578,21956946.45,-81.92605769,33.09576637,-17.880005,-7.01264617,-36.61814501,398098400
302.5,308.359985,301.850006,302.98999,4625400,36917281.66,-12.68058896,-17386241.16,308.359985,302.779999,55.4726672,64.07962562,21956946.45,-79.35023219,33.09576637,-17.089997,-7.106730256,-7.924753658,398098400
300.130005,316.799988,299.109985,315.399994,7584900,124415268.3,-11.52715121,10190745.81,316.799988,302.98999,93.17076098,70.72805239,22146395.72,-49.25341757,43.398311,-16.130005,-1.704740576,8.670859779,405683300
315,316.350006,306.899994,308.700012,5676100,128579970.7,-11.02656862,21870941.61,316.799988,302.98999,60.48792195,69.71045004,21985271.13,-59.80486483,39.83207384,-12.379975,-3.555353494,33.41716811,400007200
306.01001,312.48999,301.5,311.299988,5978700,63565964.93,-10.30130988,3974661.549,316.799988,302.98999,73.17073171,75.60980488,22033077.17,-53.30166999,41.82972164,12.039978,-6.102015221,5.401688909,405985900
313.98999,318.140015,311.299988,312.5,5822100,60129728.52,-9.519965926,-4801224.751,318.140015,302.98999,70.36255329,68.00706898,22056124.11,-50.30013772,42.77410303,6.410004,-2.672227279,-31.15888049,411808000
325.670013,326.670013,313.149994,315.049988,13735100,16477644.43,-8.595894373,-21844184.56,326.670013,308.700012,57.8373977,67.1235609,22103632.22,-43.92197545,44.82400769,12.269989,5.276340798,-30.60066494,425543100
313.790009,315.5,304.75,308.73999,8247700,42013499.53,-8.277309442,-18705424.72,326.670013,308.700012,28.76434748,52.32143282,21828537.93,-59.70486979,40.91801539,2.690002,0.865756488,-7.266696649,417295400
310.859985,318.230011,308.709991,317.809998,7261300,93479292.32,-7.20984415,654586.0782,326.670013,308.73999,64.79932291,50.4670227,22070834.71,-26.02824006,47.94040065,13.419983,4.96399995,11.95343817,424556700
316.769989,317.420013,311.839996,312.600006,4917600,65247132.71,-6.706959375,-467877.2053,326.670013,308.73999,35.81204993,43.12524011,21951797.18,-44.6100299,44.65693443,9.610016,2.14017914,-7.115199365,419639100
313.790009,316.410004,311,315.549988,3244100,13734521.48,-6.001202548,-17274908.74,326.670013,308.73999,49.26998903,49.96045396,21998204.19,-36.61513285,46.8756004,12.559998,3.666340041,-31.34615792,422883200
313.25,317.339996,309.51001,316.809998,4555900,47194543.35,-5.279355773,-11933695.7,318.230011,308.73999,89.46578753,58.18260883,22011158.08,-32.46627225,47.83749276,1.410004,4.561209431,-16.36099943,427439100
316.359985,320,313.920013,317.549988,4949500,48921728.56,-4.594612166,-8114213.649,320,312.600006,78.29929099,72.34502252,22021799.54,-30.02969211,48.42807761,8.849976,4.805438622,7.00696156,432388600
317.299988,318,301.230011,307.540009,8767400,65825856.24,-4.804288723,-435456.3969,320,307.540009,33.61748374,67.12752075,21865778.77,-62.98975388,41.57144383,-3.759979,-2.492068849,15.59018576,423621200
308.559998,310.700012,304.540009,308.850006,4351600,67302248.63,-4.809314313,3215201.546,320,307.540009,40.59669401,50.83782291,21903124.38,-64.65888569,42.71453272,-3.649994,0.048588919,-23.33468403,427972800
305.440002,310.320007,305.049988,306.529999,4292900,20714726.53,-4.943516524,-10406941.01,320,306.529999,28.2365003,34.15022602,21870436.21,-73.07689963,41.17806152,-8.519989,-1.532280496,-28.19676518,423679900
306.5,308.269989,300.609985,305.200012,5835100,27710914.76,-5.098420165,-12807490.26,320,305.200012,23.67211681,30.83510371,21851809.97,-82.38671501,40.28348281,-3.539978,-2.33599616,0.22328713,417844800
302,308,301,303.700012,4646500,34136009.87,-5.281339882,-10580867.39,318,303.700012,17.7689726,23.22586323,21823131.56,-88.14265664,39.24787026,-14.109986,-3.602595281,-66.17061397,413198300
300.100006,313.390015,300,313.26001,7195300,105031225.2,-4.601845917,13849489.34,313.390015,303.700012,99.02908996,46.82339312,21969396.06,-50.28120159,48.35978343,0.660004,1.464021554,-12.75992095,420393600
312,318.630005,311.049988,311.23999,4780600,91587444.96,-4.17817736,18307115.25,318.630005,303.700012,60.3327267,59.04359642,21922998.02,-57.85532613,46.76375723,-4.309998,-2.067275429,-34.16330409,415613000
314.600006,316.980011,311.26001,315.130005,3468500,8548824.042,-3.488314161,-7954973.1,318.630005,303.700012,81.2131022,80.19163962,21982748.08,-24.349975,50.17404912,-1.679993,0.809340675,-29.46762648,419081500
314.630005,329.01001,313.75,328.910004,7938000,132589359.5,-1.808811003,21492067.76,329.01001,303.700012,99.65527072,80.40036654,22134418.58,-0.344729285,59.95923564,11.360016,4.233882589,144.690361,427019500
330.450012,341.440002,330.029999,341.029999,8733200,216039474.6,0.494489488,58137069.5,341.440002,311.23999,99.01061057,93.29299449,22426925.71,-0.989389431,66.23928535,33.48999,7.644961066,91.68989662,435752700
340.929993,344.220001,336.5,339.029999,6221500,107309183.3,2.133890278,33247016.65,344.220001,311.23999,84.35333143,94.33973757,22375709.1,-11.73677495,64.4431071,30.179993,6.764292808,25.69956561,429531200
341.01001,347.440002,336.899994,337.890015,5799900,12044705.31,3.303064363,-10269158.56,347.440002,315.130005,73.60423131,85.65605777,22354789.38,-20.13066315,63.3880054,31.360016,9.868636636,-33.84697858,423731300
342.040009,343.899994,335.76001,343.450012,6933200,53419957.76,4.624974711,-13972817.32,347.440002,328.910004,88.15675345,82.0381054,22450227.03,-8.410602512,66.28717415,38.25,11.202851,59.32530563,430664500
344.899994,346.730011,337.579987,338.869995,5476200,55293250.43,5.24259571,-13621646.66,347.440002,337.890015,50.7753847,70.84545649,22357770.56,-18.06493811,61.93633691,35.169983,10.55035269,27.5641175,425188300
340.26001,341.48999,330.299988,331.100006,6825000,1483268.397,5.046913944,-29361012.34,347.440002,331.100006,4.667545779,47.86656131,22232206.14,-34.4434977,55.30439143,17.839996,8.486236233,16.96457644,418363300
332.690002,333.100006,325.040009,328.980011,5953800,19537674.23,4.66697092,-27386077.14,347.440002,328.980011,17.58930014,24.34407687,22188506.46,-38.91228967,53.61744738,17.740021,8.324003293,28.13515549,412409500
329.589996,333.73999,327.209991,331.660004,4385200,38531993.87,4.529898523,-18044858.57,346.730011,328.980011,30.52095154,17.59259915,22237008.32,-33.26306352,55.46675398,16.529999,5.873713022,-39.05466068,416794700
329.51001,330.920013,324.820007,325.200012,4215800,15766240.93,3.855555847,-19826657.95,346.730011,325.200012,1.734390373,16.61488068,22151594.47,-46.88024676,50.26442299,-3.709992,4.48529188,-11.8144166,412578900
323.829987,323.940002,316.579987,317.290009,4378400,-3198402.74,2.652289341,-24787357.23,341.48999,317.290009,2.850348914,11.70189694,22049051.45,-63.55394547,44.73202811,-23.73999,0.685432668,26.23324204,408200500
316,317.679993,310.75,311.640015,4712100,-760342.6583,1.228621882,-23787591.71,333.73999,311.640015,3.871315299,2.818684862,21971085.14,-97.57423017,41.24037496,-27.389984,-5.250673069,-40.63869992,403488400
311.75,315.820007,309.540009,315.359985,4316300,24891497.05,0.395961258,-13054139.38,333.73999,311.640015,24.04950649,10.2570569,22027332.31,-84.64385996,44.32194939,-22.53003,-7.527201148,-50.57596299,407804700
316.179993,316.410004,310,311.350006,3777200,26922140.93,-0.58080492,-6830327.711,330.920013,311.350006,8.465840324,12.12888737,21972448.14,-95.22428144,41.77844075,-32.100006,-8.16446718,-39.28795307,404027500
312,322.109985,311,320.529999,4352200,42975077.4,-0.607151573,1444468.462,323.940002,311.350006,76.3194121,36.27825297,22083816.91,-71.00265955,48.99473608,-18.339996,-5.137771236,-24.96077519,408379700
321,325.25,315.549988,317.25,4521500,44815058.27,-0.882526773,5283745.493,325.25,311.350006,49.07699183,44.62074809,22039280.64,-79.65701207,46.76444133,-13.850006,-7.628478988,-34.78480355,403858200
312.869995,318.549988,305.679993,314.619995,9946300,89840267.68,-1.298020258,20700221.32,325.25,311.350006,45.68216046,57.02618813,22001797.37,-78.59195385,44.99575066,-14.360016,-7.156136677,81.62777108,393911900
316.619995,317.23999,312,316.579987,4591200,106332082.6,-1.452404449,30372518.8,325.25,311.350006,55.69744559,50.15219929,22063759.96,-73.44704209,46.61617309,-15.080017,-4.385387719,-32.72967033,398503100
316,337.019989,315.5,336.410004,9859400,226329980,0.025072591,69749378.85,337.019989,314.619995,98.05365323,66.47775309,22351344.7,-25.14007911,59.58787963,11.209992,2.258493754,65.59844133,408362500
335.160004,338.799988,327.399994,333.690002,7146600,247629374.5,0.965374129,86294321.77,338.799988,314.619995,84.57129598,79.44079827,22271627.72,-21.78159356,57.52316055,16.399993,0.612071994,62.97090213,401215900
332.200012,337,330,334.799988,4309900,61081667.05,1.77962209,25861680.44,338.799988,314.619995,87.92270349,90.1825509,22295400.17,-12.07729651,58.16028564,23.159973,2.952022031,2.232079321,405525800
335.23999,344.809998,333.26001,337.950012,6645500,46553308.9,2.648569021,-5834485.014,344.809998,316.579987,79.09178172,83.86192706,22335950.61,-17.53126789,59.99418978,22.590027,6.511394123,51.77918874,412171300
338.630005,340.410004,333.670013,336.220001,4825100,36524748.98,3.161178201,-21461595.85,344.809998,333.690002,70.69260462,79.23569661,22301931.41,-21.95245567,58.47818187,24.869995,7.887300994,2.398081535,407346200
337.540009,345,334.799988,340.059998,6474300,40223653.78,3.833094804,-24726526.41,345,333.690002,71.93181639,73.90540091,22357039.29,-12.56358372,60.84336279,19.529999,7.832323115,49.9965248,413820500
340.470001,349,339.75,347.160004,7103500,82143238.75,4.882225444,-10476264.02,349,334.799988,90.31581053,77.64674384,22492214.17,-4.247450837,64.83219511,29.910004,11.50152475,88.06258604,420924000
345.670013,352.299988,343.73999,344.570007,5685800,50808778.07,5.44194655,-13664279.25,352.299988,336.220001,59.40131338,73.8829801,22439218.3,-16.5808276,62.33751366,29.950012,7.500080515,30.64197417,415238200
345,350.589996,342.600006,350.019989,4888300,35507203.02,6.253214396,-18594943.07,352.299988,336.220001,87.76166366,79.15959586,22529149.25,-4.89060327,65.35819795,33.440002,10.32938976,8.112352096,420126500
349.399994,357.829987,349.200012,351.559998,6210400,46066747.71,6.940411125,-15561728.32,357.829987,340.059998,72.77468835,73.31255513,22550656.67,-12.02299084,66.1835463,15.149994,11.74114919,-37.56070096,426336900
360,360.5,351,352.790009,5465400,15491893.6,7.497840652,-22634527.83,360.5,344.570007,62.84341687,74.45992296,22572385.14,-14.06419193,66.862633,19.100007,11.43787462,19.04077365,431802300
354.579987,354.75,343.519989,345.890015,5287500,13707424.2,7.298700839,-24038047.18,360.5,344.570007,18.37994471,51.33268331,22465490.88,-26.65082659,59.62866396,11.090027,2.817993189,-46.37097592,426514800
348.269989,349.200012,336.399994,337.640015,6740300,10630697.67,6.401383881,-23405895.62,360.5,337.640015,5.145314072,28.78955855,22339376.01,-47.13398969,52.3375118,-0.309997,1.183737294,-5.685220944,419774500
341.5,344,335.709991,342.850006,4539400,34052466.61,6.041019349,-13567098.44,360.5,337.640015,28.80198632,17.44241503,22443382.94,-39.22220889,55.99677228,6.630005,2.404426012,5.324949535,424313900
339.850006,350.850006,338.279999,349.529999,4747100,84688046.85,6.222715874,7802557.611,360.5,337.640015,55.74829763,29.89853267,22531827.33,-33.14199097,60.21438244,9.470001,3.42653842,-28.56669927,429061000
345.140015,348.269989,342.170013,345.820007,4717700,68231139.71,5.998202782,10599077.58,354.75,337.640015,53.09879843,45.88302746,22481440.52,-48.13112459,56.94960013,-1.339997,2.855275109,-2.225860604,424343300
347.51001,356.190002,345.190002,354.309998,6214100,70935287.93,6.431210864,11639966.76,356.190002,337.640015,90.8202979,66.55579799,22597261.55,-22.72395107,62.02397386,9.739991,4.190437006,-4.018967301,430557400
351,359.660004,348.630005,349.25,4197700,54251323.96,6.293525493,5699072.28,359.660004,342.850006,56.53445366,66.81785,22508516.29,-41.93069493,57.66162927,-0.769989,0.602026724,-40.90659534,426359700
348.440002,351.950012,340.51001,343.75,3704800,7988778.324,5.675184813,-11969292.01,359.660004,343.75,25.58465725,57.6464696,22442410.78,-65.17506684,53.27546719,-7.809998,-0.237979796,-34.8411833,422654900
337.970001,344.470001,333,333.130005,4464100,5514826.059,4.278876305,-18896308.39,359.660004,333.130005,0.487640587,27.53558383,22327952.72,-99.52725455,45.99940667,-19.660004,-4.825434127,-8.67786347,418190800
325.209991,336.220001,323.5,333.970001,5088400,48542335.39,3.203148507,-6321670.452,359.660004,333.130005,28.95464558,18.34231447,22339209.06,-71.7027,46.62039294,-11.920014,-5.003412533,-18.06646915,423279200
338.98999,346,335.660004,345,6969200,116793778.4,3.203724671,21113565.16,359.660004,333.130005,59.45795802,29.63341473,22507263.22,-41.89189189,54.08668619,7.359985,-2.20811497,27.51491199,430248400
343.309998,348.619995,314.600006,315.230011,10314600,60792958.26,0.792852462,12599212.85,351.950012,315.230011,1.686760104,30.03312124,21905892.18,-98.62743991,38.45334824,-27.619995,-8.864090512,95.0751773,419933800
319.929993,320.980011,294.76001,310.420013,12933700,193707448.4,-1.488746431,50261659.86,348.619995,310.420013,29.07539428,30.0733708,21748504.87,-76.17887834,36.61200093,-39.109986,-8.061841248,91.88611783,407000100
316.130005,318.079987,306.25,315.730011,6227800,255135272.9,-2.835768556,80644999.65,348.619995,310.420013,38.93428674,23.23214704,21969746.79,-67.6887474,40.02626265,-30.089996,-7.910163198,37.19434286,413227900
315.019989,324.190002,312.51001,323.660004,4560200,108441763.2,-3.226219286,39067976.51,348.619995,310.420013,53.6576347,40.55577191,22126166.54,-55.4699589,44.80742563,-30.649994,-7.401366141,-3.93714057,417788100
320.839996,326.170013,318.519989,322.309998,3950700,63619038.36,-3.603054732,4245783.99,348.619995,310.420013,51.15112453,47.91434866,22107145.67,-57.55009161,44.16196699,-26.940002,-6.798336859,-16.25792229,413837400
324.5,334.119995,322.399994,334.070007,5912900,81958162.21,-2.919115349,-4550462.997,334.119995,310.420013,99.87299792,68.22725238,22251293.44,-39.42989116,50.80944339,-9.679993,-5.712509134,-4.847041406,419750300
332.5,343.119995,331.640015,335.48999,5642600,86951995.55,-2.236724137,-6146302.247,343.119995,315.730011,79.3056522,76.77659155,22276426.55,-37.24193565,51.5593324,2.359985,-3.939874016,34.42123067,425392900
334.470001,340.839996,331.5,334.769989,4009400,28478604.36,-1.73403339,-24845560.75,343.119995,322.309998,72.72129993,83.96665002,22264316.86,-38.35133637,51.1336782,0.799988,-2.612366836,8.221766357,421383500
336.029999,339.690002,333.170013,333.299988,3219600,7768058.799,-1.437691337,-36826289.11,343.119995,322.309998,60.08128209,70.70274474,22246711.27,-40.61636123,50.2220592,-11.700012,0.051026025,-27.87795972,418163900
335.529999,347.440002,334.75,346.170013,6969800,76160733.28,-0.162461906,-16618346.19,347.440002,333.299988,94.92816057,75.91024753,22371032.71,-10.1066599,57.38533758,30.940002,3.653026309,36.97429447,425133700
347.829987,354.98999,347.100006,352.049988,5817400,105526002.6,1.307558723,2502793.068,354.98999,333.299988,87.48402192,80.83115486,22489420.35,-4.881293336,60.20310331,41.629975,2.043474783,-16.52700453,430951100
353.5,359,352.359985,357.420013,4340000,47556140.54,2.872761397,-8347405.429,359,333.299988,94.25459273,92.2222584,22578156.56,-2.459506921,62.63316687,41.690002,13.38387861,-57.92371978,435291100
356.25,359.98999,350.01001,350.98999,4797400,21302856.26,3.553385458,-20380585.68,359.98999,333.299988,66.44292424,82.72717963,22500079.51,-13.79733675,58.0614707,27.329986,13.0693819,-62.90775262,430493700
352.570007,355.23999,342.220001,343.059998,6069700,-204542.9717,3.413551552,-30293733.21,359.98999,343.059998,32.92393539,64.54048412,22391690.83,-25.95431119,52.93023765,20.75,8.656125819,-2.538617168,424424000
345.01001,348.670013,330.070007,330.929993,6885600,-1225296.961,2.297458474,-31919921.35,359.98999,330.929993,2.874286392,34.08038201,22177076.79,-44.55006272,46.20381087,-3.140014,2.246180841,50.99337748,417538400
326.980011,335.220001,322.970001,335.119995,5092800,61190193.84,1.731089886,-9823894.764,359.98999,330.929993,32.82009079,22.87277086,22264257.4,-46.27837668,48.63215299,-0.369995,3.974433644,28.90880097,422631200
332.390015,337.75,329.290009,333.350006,3823800,75371792.61,1.12643059,4620797.064,359.98999,330.929993,28.03891973,21.2444323,22237358.97,-56.10782481,47.65357627,-1.419983,-0.215523987,-35.33122495,418807400
333.75,336.369995,327.029999,328.200012,4285700,14801370.08,0.229032125,-9162490.452,355.23999,328.200012,16.20704302,25.68868451,22178284.28,-76.65777003,44.82717639,-5.099976,-2.172934578,-24.04742495,414521700
325.440002,332.5,321.73999,332.299988,5007300,54049490.54,-0.14960428,-1480116.067,348.670013,328.200012,39.21273294,27.81956523,22231822.57,-72.39216209,47.49699375,-13.870025,-0.737820319,24.88901082,419529000
332.859985,333.299988,326.269989,329.100006,3566200,60745826.55,-0.699821061,3927881.825,337.75,328.200012,45.97133918,33.79703838,22183603.28,-80.7581281,45.64064726,-22.949982,-1.260120657,10.76531246,415962800
324.100006,328.48999,322.369995,327.170013,5506800,33206844.22,-1.276886972,-2979239.034,337.75,327.170013,33.91642479,39.70016564,22162689.45,-85.80386144,44.51072017,-30.25,-5.488632547,-20.99055927,410456000
328.609985,347.209991,326.5,345.51001,8264000,181665389.3,-0.251433016,41702770.33,347.209991,327.170013,93.32555582,57.73777326,22471381.24,-37.85615686,55.72734933,-5.47998,-1.857684483,42.05658885,418720000
328.609985,347.209991,326.5,341.839996,5965800,246388818.3,0.262086009,76784431.53,347.209991,327.170013,78.91639266,68.71945776,22383600.87,-47.45096471,53.40109816,-1.220002,-4.359022,37.46082949,412754200
336.76001,339.809998,323.929993,326.630005,7967400,104867786.5,-0.551903621,39126198.14,347.209991,326.630005,17.14980147,63.13058332,22118155.74,-87.21564706,45.01448804,-4.299988,-6.940364596,66.07745862,404786800
329.380005,332.850006,321.100006,325.600006,6564800,40390318.62,-1.265520446,-351927.8663,347.209991,325.600006,17.23478585,37.76699333,22093031.24,-88.42889727,44.50476379,-9.519989,-5.089486417,8.156910556,398222000
322.929993,327.399994,319.070007,321.350006,6117300,34995481.51,-2.149231401,-18186615.96,347.209991,321.350006,8.102346469,14.16231126,22007342.05,-94.42815262,42.37267319,-12,-2.89486816,-11.15806901,392104700
316.5,320.75,309.670013,313.559998,7484300,33761621.21,-3.438530008,-24221887.92,347.209991,313.559998,10.36224635,11.89979289,21859049.49,-91.46371086,38.71186553,-14.640014,-6.433515553,46.95845115,384620400
314.869995,316.25,308.76001,310.549988,4764300,29159395.87,-4.649593475,-25953217.42,339.809998,310.549988,5.764826705,8.076473174,21787204.17,-95.51496401,37.36844855,-21.75,-6.839663294,24.59595167,379856100
310.25,322.440002,310.190002,316.529999,5958400,39803890.11,-5.068407639,-20915220.65,332.850006,310.549988,32.25400702,16.12702669,21878946.46,-79.7919562,41.69731341,-12.570007,-3.555762515,39.02979677,385814500
313.890015,318.820007,308.179993,309.100006,4939800,34933623.92,-5.931484757,-18502468.43,327.399994,309.100006,4.78674793,14.26852722,21739083.35,-97.64280541,38.16754517,-18.070007,-6.981637929,-1.348031873,380874700
311.25,311.25,300.450012,301.540009,6654900,1302583.132,-7.143166194,-26534176.55,322.440002,301.540009,4.956787156,13.9991807,21618265.26,-97.66895319,34.92768804,-43.970001,-8.374353235,86.61039762,374219800
307.339996,307.589996,291.359985,304.179993,8375200,106881033.3,-7.80048864,6185465.768,322.440002,301.540009,41.24839443,16.99730984,21676528.93,-77.04564615,36.9406945,-37.660003,-7.026933731,52.08832716,382595000
304,304.269989,277.179993,279.179993,13872000,120506603.3,-10.2208924,23343867.56,322.440002,279.179993,4.418912069,16.87469788,20988186.49,-97.14408103,28.08152489,-47.450012,-19.1977121,67.86060019,368723000
264.579987,268.679993,252.100006,257.779999,21001400,120377233.2,-13.70786475,28199880.75,318.820007,257.779999,8.513178829,18.06016177,19924855.58,-94.02797403,22.99731548,-67.820007,-24.59045108,252.0299038,347721600
256.48999,270.959991,248.210007,266.130005,15170700,374119155.7,-15.61751081,108358872.3,311.25,257.779999,28.42639592,13.78616227,20605132.62,-81.89898899,28.44137132,-55.220001,-18.52248693,90.4096694,362892300
256.26001,260.329987,244.589996,252.479996,16114000,387741004.3,-18.02458454,135634605,307.589996,252.479996,12.52380952,16.48779476,19827015.96,-92.31143989,25.2932454,-61.080002,-22.45700511,145.4606386,346778300
269.820007,273.350006,254.490005,267.529999,18844400,359018610.1,-18.5044901,125323497.1,304.269989,252.479996,38.43834734,26.46285093,20787550.46,-75.90841996,33.97130467,-43.019989,-16.74809584,208.0509375,365622700
252.779999,288.369995,252,286.940002,19896700,934324110.9,-17.1212308,292764021.6,288.369995,252.479996,96.73368426,49.23194704,22154761.1,-52.01676728,43.1442869,-29.589997,-8.489602044,165.8458373,385519400
289.339996,306.26001,288.200012,305.720001,19121100,1028838166,-14.34424731,364720160.7,306.26001,252.479996,99.12435726,78.09879628,23456984.58,-26.18040517,50.33371229,-3.380005,-1.555300978,301.3412254,404640500
301,309.279999,295.5,299.299988,13520300,376014775.7,-12.51721858,153283851.7,309.279999,252.479996,84.57256062,93.47686738,23055448.17,-29.72384357,48.09476976,-2.240021,-5.443405382,126.911587,391120200
300.369995,309.5,289.209991,289.660004,10249800,36175124.88,-11.71214102,-55278513.76,309.5,267.529999,65.49565913,83.06419234,22619980.47,-42.10660947,44.86746065,-14.519989,-6.289227312,107.4942305,380870400
298.970001,307.100006,293.679993,304.700012,10989800,113732496.7,-9.748137844,-110896816.5,309.5,286.940002,91.65219478,80.57347151,23152180.54,-22.78739709,50.45359411,25.520019,1.047954801,65.1384694,391860200
300.73999,308.980011,299.660004,300.929993,7482900,122182379.3,-8.39904128,-120879630.7,309.5,289.660004,59.76520268,72.3043522,23016204.98,-24.10078317,49.11034533,43.149994,-1.068446339,-10.65407393,384377300
302.320007,303.950012,293.679993,294.079987,7608800,-1229023.462,-7.792780447,-153241716.4,309.5,289.660004,24.00194105,58.47311284,22845873.31,-25.75759371,46.67862037,27.949982,5.337056513,-45.14994233,376768500
303.600006,303.950012,295.980011,300.339996,7327200,24358643.02,-6.729609214,-144408156.1,309.5,289.660004,54.85460849,46.20725074,23007839.98,-14.11185247,49.1563117,47.86,16.5102014,-65.11089737,384095700
299,299.660004,289.01001,291.209991,6338500,37543053.63,-6.548269083,-123471373,308.980011,291.209991,11.01642909,29.95765955,22785101.17,-28.17748863,45.81272428,23.679992,9.423960293,-58.21880335,377757200
288.869995,292.170013,282.51001,287.690002,7000000,41928990.73,-6.612366176,-102286129.6,308.980011,287.690002,19.5692928,28.48011013,22708484.81,-33.60036459,44.55443834,0.75,13.94566166,-56.55951347,370757200
291.079987,300.23999,288.160004,293.350006,6557700,63307763.13,-6.135719806,-77518363.41,303.950012,287.690002,50.55967812,27.04846667,22846202.59,-24.88059314,47.07177151,-12.369995,9.651256718,-65.20080236,377314900
291.079987,301.01001,288.549988,300.079987,6090600,100064209,-5.155491603,-48643738.69,303.950012,287.690002,81.94951195,50.69282762,22996648.11,-14.51242092,49.97981557,0.779999,4.579349309,-69.38889364,383405500
295.170013,299.980011,289.75,290.23999,5627900,67169282.11,-5.113711528,-42875801.8,301.01001,287.690002,41.78367568,58.09762191,22796929.74,-33.49566957,46.00021658,0.579986,-5.063460339,-70.56706989,377777600
291.290009,291.619995,282.329987,283.369995,4893400,-1857137.158,-5.570735726,-58581342.68,301.01001,283.369995,5.567487792,43.10022514,22663717.07,-45.44348696,43.40185779,-21.330017,-5.322416852,-63.80701612,372884200
285,287.089996,278.459991,283.459991,5685300,26778701.52,-5.858139782,-50569356.85,301.01001,283.369995,22.17293032,23.17469793,22665271.18,-83.89175725,43.44692357,-17.470002,-2.140444975,-44.53257625,378569500
283.5,285.160004,277.25,280.690002,4013600,37573791.52,-6.237522255,-39259710.66,301.01001,280.690002,14.4781168,14.07284497,22609714.06,-89.33332713,42.32972659,-13.389985,-7.879884823,-63.47886222,374555900
278.75,285.790009,276.5,285.480011,4356000,50510249.56,-6.081567381,-26947826.88,299.980011,280.690002,38.24534409,24.96546374,22678206.64,-72.78784545,44.96515626,-14.859985,-5.134078477,-41.78727499,378911900
285.369995,294.470001,283.829987,294.079987,4364600,83548736.53,-5.204036931,-8949098.85,294.470001,280.690002,97.82963841,50.18436643,22809429.47,-45.87444259,49.4331345,2.869996,0,-42.6374724,383276500
293.609985,298.730011,292.5,293.899994,4228200,47218570.01,-4.471566226,-12332026.83,298.730011,280.690002,78.27253887,71.44917379,22806758.09,-46.42860804,49.34284431,6.209992,-2.144237226,-42.29446446,379048300
293.51001,300.820007,293.220001,299.920013,4625600,33085217.35,-3.366505711,-17091834.42,300.820007,280.690002,96.29936784,90.80051504,22893365.26,-14.68122855,52.4697814,6.570007,2.990976364,-27.02374379,383673900
298.570007,306.850006,297.779999,301.149994,8970400,55036599.97,-2.364234678,-10500694.47,306.850006,285.480011,81.21907455,85.26366042,22912334.98,-18.78092545,53.10668615,1.070007,4.678644342,28.14857143,392644300
278.790009,288.040009,275.230011,284.450012,17352100,179716248.8,-2.884229046,32821086.91,306.850006,284.450012,29.15876805,68.89240348,22414890.11,-70.84123195,44.40608185,-5.789978,-3.03391642,164.6064931,375292200
283,296.859985,279.519989,294.089996,8569400,278610753.6,-2.489761762,79026332.01,306.850006,284.450012,59.64575579,56.6745328,23002951.14,-40.35424421,49.54476073,10.720001,-1.996131451,40.69878173,383861600
297.5,305.959991,295.170013,302.769989,8678200,186875739.7,-1.459911749,61555852.22,306.850006,284.450012,87.09671839,58.63374741,23255874.85,-12.90328161,53.6950587,19.309998,4.317116673,54.19961264,392539800
300.799988,307.75,299,301.970001,5930000,77083364.16,-0.70022874,13878913.52,307.75,284.450012,82.22631933,76.32293117,23232945.05,-17.77368067,53.26022342,21.279999,6.563858675,21.1836351,386609800
300.410004,307.01001,300.049988,306.850006,5727400,52509673.89,0.292232464,-14705909.54,307.75,284.450012,97.23248984,88.85184252,23328777.18,-2.767510161,55.62117835,21.369995,8.251610718,0.740506218,392337200
307.5,312.98999,304.109985,305.019989,5651600,38885298.39,0.920487237,-29397828.49,312.98999,294.089996,76.18762844,85.2154792,23294619.65,-21.10700591,54.50921485,10.940002,8.667920776,40.81124178,386685600
307.700012,308.880005,299.079987,301.059998,4679600,5602075.733,1.086323036,-43325745.4,312.98999,301.059998,33.0527082,68.82427549,23221246.47,-31.59427605,52.08278199,7.160004,5.457470366,7.428833792,382006000
303.320007,304.940002,291.619995,291.970001,7286800,986630.0682,0.478743654,-46553376.36,312.98999,291.970001,1.637838474,36.95939171,23079953.87,-55.66737471,46.91971306,-7.950012,-0.71748711,66.95229803,374719200
285.01001,286.959991,280.5,284.179993,9519200,26389185.65,-0.624160987,-35559014.4,312.98999,284.179993,11.32654396,15.33903021,22885535.85,-76.29770398,42.98685503,-16.970001,-3.307247771,125.1359917,365200000
283.829987,288.809998,281.559998,286.480011,5674000,57026746.5,-1.297669899,-18080368.38,312.98999,284.179993,18.4057028,10.45669508,22962579.74,-70.20655123,44.46692637,2.029999,-4.481195458,22.66516776,370874000
285.899994,289.190002,283.970001,284.540009,4420600,24674550.97,-1.965317555,-19580223.74,308.880005,284.179993,14.23540623,14.65588433,22924156.21,-75.34427125,43.44250613,-9.549987,-5.515518954,-50.72014626,366453400
284.649994,284.649994,274,276.820007,7251900,13700629.26,-3.08184716,-21905482.95,304.940002,276.820007,9.114437032,13.91851536,22804218.63,-92.76735644,39.53890372,-25.949982,-2.68237113,-58.20736395,359201500
281.329987,291.48999,281.299988,284.48999,9182600,38103281.03,-3.309649806,-13100837.7,291.48999,276.820007,59.97710691,27.77565006,23005150.46,-73.0956843,44.84190394,-17.480011,-3.264308929,7.155693514,368384100
287.76001,288,273.420013,275.01001,8945800,29238109.98,-4.206648576,-11128688.37,291.48999,275.01001,8.799109152,25.96355103,22699161.26,-95.98180964,40.1540634,-31.839996,-9.16866929,3.083588763,359438300
277.76001,279.910004,274,279.070007,5985100,35747393.37,-4.53761197,-7239065.445,291.48999,275.01001,31.26730045,33.34783884,22831228.89,-85.72151306,42.90686948,-25.949982,-7.583532776,0.929173693,365423400
278.399994,281.109985,274.890015,277.850006,4176700,39667752.07,-4.842525115,-3742372.346,291.48999,275.01001,24.51576446,21.52739136,22805064.03,-88.80466117,42.27755179,-23.209992,-9.450871577,-27.07511262,361246700
277.630005,279.640015,275.609985,278.850006,3875100,21969691.07,-4.946459628,-7602892.549,291.48999,275.01001,30.04980582,28.61095691,22820096.24,-86.27749266,43.0153297,-13.119995,-8.579759997,-31.43357633,365121800
278.51001,286.5,276.149994,283.76001,5666600,53418547.02,-4.579838661,1515429.948,288,275.01001,70.91910987,41.82822672,22888329.18,-73.86908514,46.62280355,-0.419983,-5.746358904,21.09154629,370788400
283.290009,295.01001,281.600006,291.720001,7489700,115580984,-3.605423081,24886843.64,295.01001,277.850006,84.34075472,61.76989014,23047287.75,-53.75284651,51.93516946,5.23999,-0.085625235,2.784487018,378278100
287.209991,290.369995,282.929993,284.730011,5919700,80126270.3,-3.358510669,20904390.92,295.01001,277.850006,48.90655291,68.0554725,22867824.82,-68.10490538,47.46753566,0.190002,0.193545645,-37.81305152,372358400
285.859985,291.950012,283.839996,291.820007,5424400,49367883.55,-2.561203421,7588047.127,295.01001,278.850006,83.55670676,72.26800479,23015229.89,-41.62436415,51.97979587,15,1.864003,-4.399013042,377782800
294.339996,299,293.549988,296.73999,4797800,56515258.32,-1.51486772,3724794.172,299,283.76001,90.10936802,74.1908759,23106683.38,-8.835070948,54.87629504,12.25,4.287615314,8.532778356,382580600
297.700012,297.799988,286.73999,291.130005,5995200,36018917.15,-1.125345759,-4715808.243,299,284.730011,54.77012808,76.14540095,23015979.1,-30.7662197,51.09199916,16.119995,5.169423321,-17.32925164,376585400
300.5,322.170013,297.480011,319.5,18767300,433929692.6,1.455793223,118867901.9,322.170013,284.730011,93.19568899,79.35839503,23600198.49,-5.476949744,64.44509726,40.429993,12.30623615,104.3789341,395352700
316.149994,330,313.579987,316.089996,14345300,435080610.9,3.189439761,158984902.6,330,291.130005,69.86567852,72.61049853,23399896.24,-24.58467161,62.24526894,38.23999,14.937633,60.35793333,381007400
319,324.480011,317.149994,317.660004,8205200,20404832.47,4.636605753,29000936.79,330,291.130005,71.47481935,78.17872896,23471148.85,-21.80982474,62.87363539,38.809998,13.82807039,37.09378289,389212600
322.51001,334.660004,322.5,332.100006,13183500,120336646.3,6.869495442,4985715.454,334.660004,291.130005,94.65776867,78.66608885,23844136.01,-4.180271679,68.1278005,48.339996,19.5249231,215.6439294,402396100
344.700012,354.970001,338,342.769989,22347400,214317148.4,9.391792326,24610946.89,354.970001,316.089996,78.77889351,81.63716051,24267706.38,-15.06732351,71.35383454,51.049988,22.92271172,476.6922144,424743500
346.709991,347.200012,339.799988,344.779999,9469800,134593760.9,11.42126456,5035559.479,354.970001,316.089996,75.38053019,82.93906412,24398751.97,-12.72477995,71.93022269,60.049988,21.50408333,67.11608372,434213300
347.630005,358.75,346.600006,357.720001,10981000,165240587,13.91340092,6320931.16,358.75,317.660004,97.52404122,83.89448831,24754164.79,-1.238872762,75.36655056,65.899994,22.62443431,46.61468417,445194300
353.839996,364.670013,351.25,358.170013,10848300,190993755.4,15.74327052,14466324.86,364.670013,332.100006,84.58620347,85.8302583,24767978.9,-7.342971763,75.47897705,61.430023,25.7928561,83.25759751,456042600
355.399994,373.730011,354.5,370.829987,12073200,265150463.1,18.00743101,40078727.02,373.730011,342.769989,91.88350656,91.33125042,25151425.84,-3.147751919,78.45769262,79.699982,27.07490169,122.5720817,468115800
365.160004,370,346.25,352.549988,12761900,266357645.9,18.11789949,47297110.91,373.730011,344.779999,37.57733969,71.34901657,24556279.57,-23.3260119,65.99216017,33.049988,18.80771041,165.994831,455353900
358.040009,364.380005,352,362.220001,8383700,155241846.9,18.76937414,10595321.8,373.730011,352.549988,58.1149731,62.52527312,24906322.8,-12.80454787,68.8148235,46.130005,24.4186428,39.8402055,463737600
362,366.209991,346.269989,347.51001,7967100,86626400.74,17.89244616,-27214444.95,373.730011,347.51001,4.585187393,33.42583339,24565855.27,-30.14138944,60.57791254,29.850006,8.766826291,-57.54796907,455770500
351.540009,352.25,332,333.630005,10266100,9701780.734,15.89425495,-64684051.8,373.730011,333.630005,3.906073737,22.20207808,24247638.86,-46.09724833,54.00877173,1.529999,5.549055403,-28.4357943,445504400
330.119995,338.470001,327.5,333.01001,6931300,42035738.89,14.09813112,-63844081.39,370,333.01001,12.96472941,7.151996847,24228561.04,-53.40328,53.72849812,-9.759979,4.832212368,-15.5255204,438573100
336.049988,343.549988,325.799988,342,7452500,154821497.1,13.24739933,-21810072.12,366.209991,333.01001,40.08911358,18.98663891,24415679.5,-52.75145194,57.19704355,-2.779999,2.98102795,-43.47100542,446025600
345,350.790009,339.5,344.5,8333700,157105353.9,12.62933426,-1904925.532,366.209991,333.01001,46.2757006,33.10984786,24470156.84,-51.66136836,58.13683467,-13.220001,0.50471484,-62.70841351,454359300
348.660004,357.019989,346.109985,349.929993,8398000,63648427.97,12.43433305,-23325030.57,357.019989,333.01001,77.29021213,54.55167544,24601512.23,-46.45717917,60.18178741,-8.24002,1.493704396,-11.31808486,462757300
353.329987,353.859985,342.410004,342.950012,6492400,23942631.67,11.58304491,-42601005.95,357.019989,333.01001,54.93281054,59.49957442,24433999.06,-64.2186193,56.36991589,-27.879975,-4.128924566,-40.87605865,456264900
360.070007,364.779999,329.850006,335.070007,18759800,79289617.8,10.15547638,-29003408.84,364.779999,335.070007,23.7814684,52.00149703,24284822.38,-80.65926444,52.33941543,-17.479981,-6.449452819,72.92847727,437505100
331.75,332.48999,309.690002,310.859985,12282600,84687988.71,6.989995268,-19086418.48,364.779999,310.859985,2.123766679,26.94601521,22929358.86,-98.17304367,42.32618728,-51.360016,-16.17183186,1.734420038,425222500
313.76001,314.390015,296.220001,309.160004,17476400,223832421.2,4.294648391,30978889.61,364.779999,309.160004,18.87398392,14.92640634,22862189.76,-83.30537823,41.72258616,-38.350006,-12.30747,36.9419914,407746100
304.950012,312.070007,302,308.899994,8865500,279495365.1,2.113225984,66354826.01,364.779999,308.899994,18.49473945,13.16416335,22847491.74,-83.64083168,41.62481206,-24.730011,-14.7203376,5.746865942,398880600
311.98999,318.519989,308,318.51001,7596800,138216297.4,1.146662971,29842112.45,364.779999,308.899994,32.51168269,23.29346869,23123301.39,-69.78854798,46.60527499,-14.5,-8.345083355,-4.647864342,406477400
324.559998,327.679993,319.200012,322.470001,9471500,104987770,0.69221359,1619460.695,332.48999,308.899994,72.37388465,41.12676893,23217751.35,-62.49463673,48.55312361,-19.529999,-3.345024078,-7.740037599,415948900
315.799988,321.940002,315.070007,318.959991,4884100,42033017.57,0.048274234,-30104450.87,327.679993,308.899994,72.28224979,59.05593904,23114656.31,-67.50965388,46.91929257,-25.540009,-4.219098099,-29.53558496,411064800
321.429993,323.230011,312.769989,316.709991,5721200,35855843.17,-0.636273971,-42311111.02,327.679993,308.899994,57.28191203,67.31268215,23080203,-70.11378268,45.85410273,-33.220002,-7.394739474,-23.23113049,405343600
315.579987,319.579987,309.25,318.869995,5869800,75039366.28,-0.993041915,-30990795.45,327.679993,316.709991,55.23373408,61.59929863,23119222.34,-66.96325166,47.09581874,-24.080017,-7.439769231,-29.56549912,411213400
311.709991,315.160004,306.25,310.100006,7818700,81725804.76,-1.960844505,-21414909.07,327.679993,310.100006,17.96550284,43.49371631,22957783.26,-79.75495128,42.80374057,-24.970001,-11.38227297,-6.898070969,403394700
308.809998,324.73999,308.5,322.690002,6996200,124054751.9,-1.692418426,-2082389.729,324.73999,310.100006,88.91298481,54.03740724,23275220.86,-61.39147933,49.86721432,11.830017,-5.90756941,7.759842277,410390900
325,325.5,316.25,323.850006,5624200,140133677.3,-1.370290342,11131698.07,325.5,310.100006,91.4286026,66.10236341,23300370.75,-59.69952479,50.47409278,14.690002,-3.348554262,-70.01993625,416015100
316.329987,323.540009,314.01001,320.230011,5915300,76479367.59,-1.391069474,-4728155.299,325.5,310.100006,72.62343377,84.32167372,23237503.45,-64.97956432,48.5009291,11.330017,3.014227129,-51.8400013,410099800
321.230011,323.23999,311.709991,313.579987,5162200,40066972.02,-1.921983023,-22372207.06,325.5,310.100006,38.07785455,67.3766303,23114663.97,-74.67913287,45.01921999,-4.930023,1.429674907,-70.46188002,404937600
301.839996,305.5,292.859985,303.200012,10992900,116994931.4,-3.144070185,-3079313.235,325.5,303.200012,31.67898973,47.46009268,22943787.29,-73.90859022,40.17169197,-19.269989,-1.845251574,23.9963905,393944700
304.420013,307.720001,292.549988,297.429993,9590800,151964198.6,-4.526002437,16219756.82,325.5,297.429993,14.81032845,28.18905757,22734587.96,-86.10872671,37.73904606,-21.529998,-6.618321666,26.24789385,384353900
296.73999,309.619995,294.5,308.73999,7075400,140639420.3,-4.654912534,19036969.05,323.540009,297.429993,52.24262997,32.91064938,23099285.27,-53.91403446,44.79574023,-7.970001,-4.25776381,-25.29799926,391429300
304.850006,310.700012,303.640015,306.649994,4630500,111623215.2,-4.869586364,9226402.488,323.23999,297.429993,45.94332056,37.66542633,23051388.79,-59.86335328,43.80763548,-12.220001,-3.859417277,-5.192358879,386798800
307.25,307.690002,295.339996,297.179993,5703300,16921863.69,-5.737725924,-25758023.16,310.700012,297.179993,25.50963569,41.23186208,22908389.15,-86.82036908,39.55058824,-12.920013,-6.166524125,-0.312871426,381095500
295.899994,296.100006,286.130005,290.170013,6814100,29116579.16,-6.91170574,-33848058.45,310.700012,290.170013,16.44284432,29.29860019,22773857.82,-89.73835785,36.70704693,-32.519989,-9.000527629,16.08743058,374281400
292.25,298.320007,289.070007,298.140015,5076900,69424837.92,-7.116940984,-21255167.05,310.700012,290.170013,48.88077565,30.27775189,22961018.41,-69.49450971,41.82795805,-25.709991,-3.856817404,-35.06721066,379358300
297.98999,303,293,300.839996,10129400,123175235.3,-6.981249987,2931157.416,310.700012,290.170013,59.86970618,41.73110872,23006995.24,-62.63654339,43.49581744,-19.390015,-6.771206379,44.78431148,389487700
328.440002,349.98999,323.160004,349.540009,23215000,689248965.1,-2.91047965,192673462.6,349.98999,290.170013,99.29536313,69.34861499,24646743.68,-0.704636871,63.70787654,35.960022,7.932685664,312.7698162,412702700
347.809998,355,342.529999,348.170013,13656500,681565466.8,0.202750757,250334795.9,355,290.170013,90.08278279,83.08261737,24555754.21,-9.917217215,63.0248825,44.970001,8.724979246,130.8674116,399046200
345.459991,354.980011,341.820007,341.98999,8564300,62545110.12,2.146587553,54204791.9,355,298.140015,80.26693253,89.88169282,24313351.13,-18.89067946,59.90497205,44.559997,9.059890356,65.90407191,390481900
343.839996,387.459991,339.149994,379.570007,30875800,1235959712,6.642910186,342401273.4,387.459991,300.839996,91.64727424,87.33232985,25254450.43,-7.786425629,69.72078476,70.830017,25.18799208,180.87038,421357700
369.089996,382.640015,367.119995,370.339996,24571200,1302603579,9.353670231,450377312.3,387.459991,341.98999,73.37480799,81.76300492,24503643.02,-16.89529001,65.48065922,63.690002,24.51333245,156.1955207,396786500
365.549988,367.01001,345.730011,352.450012,17183800,163363791.7,9.943769317,91120549.33,387.459991,341.98999,27.53057095,64.18421773,23316684.07,-34.55046268,58.10467556,55.270019,14.15755115,142.8668344,379602700
354,360,346,355.48999,11552000,209624779.3,10.53528372,-49412407.59,387.459991,341.98999,33.82321883,44.90953259,23464899.05,-31.55038529,58.95084301,65.319977,15.92695156,149.4762985,391154700
361.130005,363.190002,349.019989,356.410004,10463900,178228624.6,10.95205215,-112400811.2,387.459991,352.450012,35.72761555,32.36046844,23494795.82,-30.64244675,59.21928735,58.269989,19.93068591,83.47097295,401618600
358.450012,359.200012,347.100006,347.640015,6986400,69419776.32,10.45417014,-162571536.2,382.640015,347.640015,5.174759667,24.90853135,23237316.27,-39.29732705,55.49379458,46.800019,19.80563098,2.528580443,394632200
341.910004,344.48999,332.140015,338.690002,9101300,52437215.81,9.230994658,-173720235.1,367.01001,338.690002,18.78402047,19.89546523,23057450.98,-48.12986849,51.90507386,-10.850007,13.60098778,79.26884516,385530900
339.910004,342.279999,333.820007,335.450012,6064000,60327816.48,7.909009025,-159977672.1,363.190002,335.450012,10.66022024,11.53966679,22970385.76,-51.32733266,50.6286461,-12.720001,11.50445967,-40.13465753,379466900
323.5,326.769989,303.529999,305.5,18958600,24985652.63,4.393959392,-151057523.8,363.190002,305.5,3.302046431,10.91542905,22428973.13,-83.30115289,40.67187292,-36.48999,-12.59941863,-18.33469739,360508300
291.700012,308.5,288.200012,308.440002,17402300,372167882.6,1.82445959,-23208796.83,359.200012,305.5,28.50702817,14.15643161,22611422.63,-79.60911316,41.8801924,-71.130005,-11.41109502,27.42869696,377910600
310.609985,324.790009,309,321.899994,13172200,519681362.8,0.864258713,78138953.06,344.48999,305.5,59.86852935,30.55920132,23370840.4,-66.04877178,47.18378629,-48.440002,-5.874439775,53.80357998,391082800
320.869995,323.880005,314.670013,321.640015,5946000,207507905.8,0.08137641,13167936.86,342.279999,305.5,61.83433994,50.06996582,23360202.02,-66.31068902,47.09439535,-30.809997,-15.26200462,-80.74219939,385136800
319.140015,327.320007,318.100006,320.100006,5147300,46261338.11,-0.655770003,-65913926.46,327.320007,305.5,81.54396237,67.74894388,23331732.63,-67.86217938,46.53202514,-35.389984,-13.56590985,-79.05149118,379989500
320.700012,323.850006,319.399994,322.820007,3602600,17750932.52,-1.008853067,-101344915.4,327.320007,308.440002,88.49693105,77.29174445,23375471.03,-65.12189973,47.71949701,-33.589997,-8.406867355,-79.03490497,383592100
318,322.440002,308.809998,319.269989,13079300,145254509.5,-1.557180515,-66056916.76,327.320007,319.269989,56.5099185,75.5169373,23335853.61,-67.10083014,46.2749821,-28.370026,-10.18875412,13.22108726,370512800
318.410004,318.880005,311.190002,311.859985,7649100,131909514.2,-2.560147575,-49861877.95,327.320007,311.859985,16.47750144,53.828117,23032293.4,-69.97846263,43.32679332,-26.830017,-12.49965447,-26.90010417,362863700
310.269989,311.850006,303.690002,305.01001,7447400,1730047.097,-3.86320926,-80124476.34,327.320007,305.01001,5.586152013,26.19119065,22864281.64,-77.5836775,40.74266716,-30.440002,-12.26268645,6.598534295,355416300
302.26001,304.600006,297.720001,303.149994,7216700,41253618.28,-4.988478702,-72644905.18,323.850006,303.149994,20.78068106,14.28144484,22818865.81,-80.06402988,40.04425821,-2.350006,-10.49337382,-20.70693198,348199600
302,305.309998,298.600006,301.660004,5375100,51189591.94,-5.932110901,-59819552.16,322.440002,301.660004,15.93852282,14.1017853,22783395.55,-81.04226479,39.4607102,-6.779998,-10.07303824,-11.36048813,342824500
296.940002,298.190002,288,288.950012,8350500,13885025.2,-7.61772397,-61004310.61,318.880005,288.950012,3.076463232,13.26522237,22556923.77,-98.31826488,34.80179702,-32.949982,-5.417344681,-55.95402614,334474000
285.049988,286.779999,277.179993,280.73999,7720800,22989441.41,-9.50647985,-53046278.39,311.850006,280.73999,10.26823093,9.761072328,22319658.55,-94.53149513,32.16044943,-40.900025,-8.980680787,-55.63345075,326753200
284.799988,291.170013,278.880005,280.950012,7480800,31892850.72,-10.8611845,-42135427.85,305.309998,280.73999,13.40212702,8.915607061,22325434.49,-92.48101726,32.30199781,-39.149994,-12.72133668,-43.20766463,334234000
260.100006,268.350006,252.25,263.23999,22491900,249311503,-13.21155389,35337257.45,305.309998,263.23999,20.71238299,14.79424698,21853873.26,-85.36034504,27.15642706,-59.580017,-18.15695258,278.2694248,311742100
273.26001,286.029999,271,285.5,14283500,446654077.5,-13.12672508,126608969.9,298.190002,263.23999,72.37701034,35.49717345,23755825.62,-55.70800999,40.07716847,-33.769989,-10.80912382,177.4949974,326025600
279.470001,282,273.549988,279.440002,9170000,257840378.9,-13.39409009,92360405.47,291.170013,263.23999,69.86123566,54.31687633,23452645.29,-63.78047227,38.09606082,-32.419983,-13.43783039,154.5383889,316855600
281.440002,292.5,278.649994,290.540009,10015400,168899225.9,-12.56545426,41653770.82,292.5,263.23999,95.13045714,79.12290105,23816899.03,-48.99426478,43.59598289,-14.470001,-8.998647223,-23.42556559,326871000
288.019989,295,285.179993,289.459991,6340300,141225479,-11.85919738,8318158.03,295,263.23999,87.04091462,84.01086914,23779669,-48.03074318,43.1938656,-13.690003,-7.182708612,-17.11050973,320530700
288.76001,297.329987,286.519989,295.200012,6765600,80952044.15,-10.71282125,-25253245.39,297.329987,279.440002,91.91045936,91.36061037,23905397.79,-38.80893179,46.04242867,-6.459992,-3.216287229,-9.154872842,327296300
290.040009,300.869995,288.130005,294.839996,6887600,100348232.2,-9.721299104,-30519737.38,300.869995,279.440002,77.928267,85.62654699,23897146.7,-36.07985471,45.88700637,5.889984,-2.741216614,-4.560256073,320408700
296.690002,302.640015,275.5,284.959991,16547500,188715284.2,-9.621830028,-1782900.505,302.640015,284.959991,34.85624824,68.2316582,23666345.17,-45.11747029,41.72440079,4.220001,-5.536038182,207.8547376,303861200
280.51001,300,280.5,299.019989,8294900,298964118.9,-8.312652649,45214334.75,302.640015,284.959991,86.66166544,66.48206023,24482803,-11.85452174,48.83722975,18.069977,3.485023908,-0.665828394,312156100
303.559998,305.980011,293.329987,298.329987,7349400,185507075.9,-7.247255686,24230114.13,305.980011,284.959991,74.90150512,65.4731396,24463662.15,-14.2378977,48.52421564,35.089997,6.265582969,-4.810382344,304806700
297.700012,300.579987,295.369995,299.100006,5050500,49706241.47,-6.26852714,-29766433.8,305.980011,284.959991,77.42781326,79.66366128,24482631.67,-12.80477125,48.91769248,13.600006,6.460221828,-32.48716715,309857200
298.480011,303,293.579987,299.679993,4843000,45239198.87,-5.38401405,-50571222.98,305.980011,284.959991,79.33065707,77.21999182,24492425.13,-11.72532423,49.23247003,20.239991,13.84288269,-78.46780396,314700200
300,304.600006,296.5,300.98999,4481700,45960834.26,-4.525161993,-54255277.94,305.980011,298.329987,80.4159386,79.05813631,24513595.43,-9.287213807,49.98218243,10.449981,5.425565674,-68.6232366,319181900
301.910004,313.890015,301.109985,309.579987,7843200,81912204.45,-3.115461482,-39391021,313.890015,298.329987,79.03685734,79.59448433,24641499.32,-6.992256572,54.70564163,20.119996,10.78585198,-14.46892039,327025100
312.899994,314.959991,306.910004,307.519989,8509100,61112920.76,-2.139821759,-36347140.61,314.959991,299.100006,65.2011197,74.88463855,24589309.33,-16.92448481,53.40319147,12.319977,5.844282878,-15.03983865,318516000
270.26001,278,260.559998,264.769989,33649700,113464320.1,-4.76130264,-15140367.89,314.959991,264.769989,7.73895504,50.65897736,23406413.78,-92.26104496,34.85649083,-30.070007,-8.529676904,430.7272527,284866300
305.769989,311.440002,301.049988,310.700012,21777600,324741556.9,-3.09697611,62136102.48,314.959991,264.769989,92.16915524,55.03640999,29243674.65,-7.830844758,53.52973655,25.740021,5.250677293,221.887194,306643900
313.950012,316.839996,299.149994,301.019989,11743500,220061516,-2.529918969,54793181.65,316.839996,264.769989,71.89053383,57.2662147,28565182.02,-28.10946617,50.25983886,2,2.09604975,70.50206168,294900400
303.329987,304.600006,291.570007,294.799988,7995000,31268744.66,-2.552994862,-13262366.07,316.839996,264.769989,60.83864822,74.96611243,28322525.1,-39.16135178,48.22149037,-3.529999,3.453115283,-51.68454449,286905400
293.950012,294,277.670013,281.829987,9814200,53323293.11,-3.576624261,-32880245.98,316.839996,264.769989,37.79315877,56.84078027,27970777.6,-62.20684123,44.19637586,-17.270019,-5.748780226,18.31607373,277091200
274.649994,274.880005,260,261.950012,17944500,52911831.88,-5.923720807,-38047548.53,316.839996,261.950012,3.430703971,34.02083699,27278494.81,-96.56929603,38.84426579,-37.729981,-12.19454181,144.1627888,259146700
264.519989,267.76001,249,250.559998,13472700,28064115.95,-8.603712428,-44608668.4,316.839996,250.559998,2.299525489,14.50779608,26498238.67,-97.70047451,36.143646,-50.429992,-16.22868841,166.7597268,245674000
255.25,266.769989,253.300003,262.799988,12060600,119685919.7,-9.6289635,-14085037.29,304.600006,250.559998,24.82011962,10.18344969,27156387.27,-79.65803536,40.8988986,-46.779999,-12.30646218,149.031592,257734600
264.609985,265.51001,247.770004,256.880005,12815300,221534024.9,-10.79474046,32088575.91,294,250.559998,19.7058226,15.60848924,26884703.29,-86.81047914,39.37176024,-50.639984,-14.65496743,185.9472968,244919300
257.529999,262.25,249.029999,252.229996,8167700,130459085.7,-11.95602239,19082248.32,274.880005,250.559998,16.4514638,20.32580201,26652722.37,-93.54279352,38.16626782,-12.539993,-18.52509639,4.137341901,236751600
261,261.98999,252.009995,258.779999,7201400,66383196.62,-12.20710033,-8361054.802,267.76001,250.559998,55.07749723,30.41159454,26864824.26,-84.05965502,40.91075062,-51.920013,-15.84937297,-15.36825281,243953000
259.059998,263.279999,254.539993,259.589996,6200000,75129628.31,-12.20008641,-16044809.2,266.769989,252.229996,62.21053332,44.57983145,26887365.08,-82.88693591,41.25797528,-41.429993,-1.956412439,-81.57487288,250153000
265.700012,277.380005,262.23999,276.589996,9526400,164899205.8,-10.69943349,10833503.15,277.380005,252.229996,97.33195213,71.53999423,27293389.97,-58.27422131,48.14515787,-18.209992,-10.97844052,-56.25596944,259679400
282.399994,282.700012,265.799988,271.779999,8655500,182374009.6,-9.785480876,26404477.28,282.700012,252.229996,67.56754148,75.70334231,27127722.53,-65.23816739,46.48449539,-10.049988,-9.713637323,-26.29539745,251023900
269.290009,271,263,263.910004,5421200,46295979.77,-9.585711549,-12923540.72,282.700012,258.779999,38.77485307,67.8914489,26877083.26,-76.6323992,43.82115363,1.959992,-10.47828537,-32.19262039,245602700
267.390015,269.660004,253.5,260,9375500,55465112.98,-9.631867392,-24919956.54,282.700012,259.589996,22.26026482,42.86755313,26796764.54,-82.29332935,42.51775712,9.440002,-7.745799953,-4.470053596,236227200
260.679993,261.859985,252.589996,260.950012,5600300,101605188.6,-9.482480073,-12881197.46,282.700012,260,27.76490056,29.60000615,26831021.61,-76.80801067,42.96166835,-1.849976,-0.381752225,-68.79099446,241827500
263.869995,297.929993,262.100006,294.140015,19027800,653907038.7,-6.609740709,168947174.3,297.929993,260,91.64098313,47.2220495,27543318.85,-7.555779169,55.80318424,37.26001,17.39304651,41.2322697,260855300
301.049988,304.440002,285.730011,288.5,20058300,646110759.9,-4.733610031,225492040,304.440002,260,69.25747318,62.88778562,27178468.53,-28.12776171,53.59501905,36.270004,9.779304861,66.31262126,240797000
317.220001,321,301.01001,314.859985,20840700,320714434.3,-1.106971978,124589559.6,321,260,91.02468259,83.97437963,29011177.33,-8.384562796,61.30239064,56.079986,22.57084198,62.62358275,261637700
308.25,339.899994,306.649994,330.899994,27425500,939886791,3.026571054,268994334.8,339.899994,260.950012,89.69190218,83.32468598,30072871.51,-9.76880601,65.10079633,71.309998,31.1897868,235.7799625,289063200
337.470001,347.160004,326.5,334.850006,14486000,769971821.3,6.545711755,249551131.1,347.160004,288.5,85.5278647,88.74814982,30400254.58,-12.38554985,65.98621896,58.26001,29.39562845,101.1553309,303549200
328.390015,337.899994,322.26001,329.899994,9126700,177386338.3,8.833405514,30360700.4,347.160004,288.5,71.90295952,82.37424213,30186111.31,-17.58892196,63.8016803,58.119995,27.08501833,47.20483871,294422500
332.540009,342,329.100006,337.320007,7624300,124965179.8,11.11700245,-78747635.38,347.160004,314.859985,78.67822691,78.70301704,30391386.35,-10.34156182,65.63807919,73.410003,21.95669109,-19.96661908,302046800
338.26001,347.839996,334.730011,344.279999,8000100,134134175.1,13.33466891,-113306580.1,347.839996,329.899994,91.35713322,80.64610655,30548700.07,-3.737529659,67.31317666,84.279999,26.67598803,-7.572064006,310046900
343.73999,349.200012,340.910004,346.410004,7808000,114544655.8,15.09010976,-123376760.9,349.200012,329.899994,89.64362363,86.55966126,30598195.41,-2.887907606,67.83003298,85.459992,31.26065657,44.02715266,317854900
340.5,343.959991,330.140015,341.399994,7831000,127042501.9,15.89382917,-112303723.7,349.200012,329.899994,71.04670594,84.01582093,30485270.96,-8.073715669,65.21783467,47.259979,31.30769,-16.47378806,310023900
339.070007,348.799988,336.089996,341.059998,6762900,116219520.5,16.31527542,-101008091.4,349.200012,337.320007,59.50243,73.39758652,30477472.16,-8.425641913,65.03479308,52.559998,30.69936092,20.75960216,303261000
343.339996,351.179993,340.799988,348.160004,7374500,81624110.07,17.02592154,-98212227.7,351.179993,341.059998,85.64642511,72.06518701,30618258.63,-3.063179929,67.11069886,33.300019,18.36539955,-61.24354891,310635500
348.5,357.579987,348.440002,351.399994,7090700,68324923.97,17.6471287,-92371640.16,357.579987,341.059998,77.47813664,74.20899725,30686886,-5.886268721,68.0431063,20.5,21.80242426,-64.64954657,317726200
349,354,345.230011,350.51001,5098800,41086651.78,17.86172672,-90251610.03,357.579987,341.059998,74.23475141,79.11977105,30668927.52,-7.404669467,67.47721703,15.660004,11.32250102,-75.53441103,312627400
348.369995,349.779999,330.339996,331.279999,6941500,24811787.72,16.29228865,-86357999,357.579987,331.279999,3.450819789,51.72123594,30389192.34,-36.60403171,56.53623658,1.380005,0.114839833,-74.68961368,305685900
333.160004,344.700012,332.200012,338.730011,5448600,32896281.26,15.47130778,-74342092.08,357.579987,331.279999,30.80035893,36.16197671,30545296.72,-33.32151965,59.2902119,1.410004,1.158729261,-62.3871324,311134500
342.700012,347.109985,337.149994,344,5040300,65929363.55,15.07217593,-52157595.61,357.579987,331.279999,50.14687413,28.13268428,30630066.48,-26.66402683,61.16475811,-0.279999,4.274024328,-44.77412427,316174800
342.329987,348.579987,339.040009,348.440002,4625700,76365935.14,14.9418913,-35019792.85,354,331.279999,76.50043508,52.48255605,30695121.54,-25.87766408,62.7221789,2.029998,3.296571436,-39.32951222,320800500
345.190002,355.700012,345.119995,354.309998,7206200,108691913.7,15.13780027,-14539717.39,355.700012,331.279999,94.5188757,73.72206164,30773048.42,-9.258185531,64.73569281,12.910004,2.91332608,-9.923625955,328006700
356.339996,366.75,352.880005,353.470001,9708900,61710546.58,15.05177135,-19788329.01,366.75,338.730011,61.56294179,77.52741752,30755963.98,-35.27224732,64.20128542,12.410003,2.038046511,24.34554303,318297800
341.75,349.799988,333.549988,347.48999,8004700,106879941.4,14.33580171,-5764469.152,366.75,344,41.98794265,66.02325338,30591708.66,-52.60862576,60.37982446,-0.670014,1.783830143,2.218107521,310293100
352,353.100006,337.399994,338.190002,4686800,109699280.4,12.86960648,1393669.503,366.75,338.190002,13.97594073,39.17560839,30377476.26,-78.01149878,54.90623229,-13.209992,-0.841492997,-30.69836904,305606300
334.350006,337.5,325.549988,325.829987,4202600,-3675761.377,10.58823175,-31878575.21,366.75,325.829987,0.679609025,18.88116414,30206185.22,-99.32039097,48.60040887,-24.680023,-6.41372264,-43.01172961,301403700
325,346.220001,325,346,7992100,164823835.2,10.28917016,11021612.25,366.75,325.829987,50.2994012,21.65165032,30466340.82,-49.7005988,57.23233253,14.720001,-1.53670862,12.71242614,309395800
340.049988,346.959991,335.5,343.920013,6358300,219601551,9.771682267,44998997.39,353.100006,325.829987,67.33099274,39.43666765,30418296.13,-54.68260359,56.18447229,5.190002,-1.880116633,24.70189064,303037500
345.98999,348.279999,342.209991,347.869995,4127600,74933740.24,9.569983108,8777351.766,353.100006,325.829987,81.38786518,66.33941971,30491322.33,-45.22156886,57.76588242,3.869995,5.007847153,-40.53734784,307165100
347,347.5,339.549988,341.170013,3080700,25621315.2,8.768425566,-22528852.3,348.279999,325.829987,69.45882171,72.72589321,30411824.68,-61.26942994,54.19296804,-7.269989,0.720338299,-43.45887017,304084400
341.829987,351.600006,338.26001,350.480011,5629100,70852886.54,8.783177469,-18895994.69,351.600006,341.170013,95.78949343,82.21206011,30495892.18,-38.97003353,58.07357506,-3.829987,1.883724128,11.68184433,309713500
360,366,352,358.48999,8306500,117768253.6,9.33361472,-764391.1863,366,341.170013,75.37701639,80.20844385,30624541.38,-19.78445509,61.12501104,5.019989,2.884280778,79.57282141,318020000
356.049988,368.679993,352,359.700012,8461900,110054364.1,9.755028969,4268153.712,368.679993,341.170013,70.47999336,80.5488344,30652578.56,-20.55856786,61.57991667,12.210022,1.521270647,17.42527268,326481900
356.01001,367.380005,350.76001,363.059998,7842500,155025280.3,10.24206148,20247835.97,368.679993,341.170013,81.52531841,75.79410939,30731621.83,-12.86629098,62.87889182,24.869996,2.71310068,-19.22359897,334324400
369,379.48999,357.649994,357.970001,11511200,86765298.79,10.10088136,3225181.334,379.48999,350.480011,47.80499772,66.6034365,30621672.23,-39.4934721,59.59192946,32.140014,3.015917379,43.80551426,322813200
360,365.980011,353.119995,365.149994,6613500,71474677.43,10.44792337,-8897027.933,379.48999,357.970001,50.08699623,59.80577079,30852558.44,-26.31675286,62.56470608,19.149994,7.971847731,41.10907229,329426700
369.910004,372.170013,360.230011,366.76001,6308800,117471493.6,10.72919205,1588057.766,379.48999,357.970001,55.69095419,51.19431605,30881718.62,-23.36205237,63.21816518,22.839997,12.5617729,50.11659449,335735500
369.420013,371.910004,365.160004,366.600006,5027000,41622264.91,10.8145254,-18400803.36,379.48999,357.970001,55.13403072,53.63732705,30878966.32,-23.65569162,63.10028147,18.730011,5.95375896,-37.10038663,330708500
370.149994,377.440002,366.75,376.790009,7365900,76790145.62,11.5710173,-13715484.2,379.48999,357.970001,89.76116226,66.86204906,31018696.67,-4.955003662,67.28432285,35.619996,9.557453698,15.84700313,338074400
375,377.869995,364.329987,365.709991,6337600,76560071.94,11.14797085,-10625105.79,377.869995,365.149994,50.86867071,65.25462123,30802092.45,-25.28904667,59.39766295,15.22998,5.128351469,53.54200988,331736800
362,365.700012,343.880005,348.420013,7674000,31816966.67,9.310224301,-22631383.95,377.869995,348.420013,13.35689713,51.32891003,30502464.42,-70.62965234,49.62301673,-10.069977,2.125040222,149.0992307,324062800
350.540009,351.549988,333.690002,337.029999,7100000,46704472.24,6.855689853,-20748711.07,377.869995,337.029999,7.5599763,23.92851471,30251597.75,-92.70742822,44.43532082,-22.670013,-3.83759746,26.13028726,316962800
337.600006,347.01001,329.73999,332.970001,8274200,37940830.34,4.53061955,-20880711.76,377.869995,332.970001,6.711013223,9.209295552,30166068.31,-93.50751558,42.7208979,-30.089997,-7.118745212,-0.388852104,308688600
327.049988,330.290009,311.869995,315.380005,9071900,44498328.1,1.254161716,-16949988.96,377.869995,315.380005,5.31819697,6.529728831,29728962.44,-94.80921287,36.20361991,-42.589996,-12.32138046,7.208782897,299616700
317.399994,323.470001,312.440002,319.769989,8016800,80573052.93,-0.97695794,-2322736.373,365.700012,315.380005,14.67581554,8.901675244,29855240.24,-88.31707397,38.71638633,-45.380005,-11.92365153,2.222505579,307633500
313.5,314.5,295.200012,295.390015,5559900,51625038.41,-4.658693967,-5338434.353,351.549988,295.390015,0.337183817,6.777065442,29244021.61,-99.77458411,31.33496107,-71.369995,-17.48190793,-51.7000834,302073600
300,326.970001,294.089996,326.089996,8163100,256551955,-5.041153123,59117202.15,347.01001,295.390015,60.4686159,25.16053842,29821863.84,-62.52927137,45.44090419,-40.51001,-10.69697347,23.43086112,310236700
319.839996,322.170013,301.5,316.130005,8575100,383948737.8,-6.077880767,120646466,330.290009,295.390015,60.8839809,40.56326021,29572532.66,-74.19202512,42.39780993,-60.660004,-13.80466889,35.92283794,301661600
323.100006,336.23999,318.410004,333.869995,9939000,275283756.3,-5.405712275,100274446.5,336.23999,295.390015,94.37723526,71.90994402,30053734.02,-52.51850146,48.95477233,-31.839996,-8.927989761,97.71235329,311600600
337.790009,339.209991,325.26001,332.799988,6302300,196959042.6,-4.902837664,57903079.95,339.209991,295.390015,85.79343149,80.35154922,30021880.91,-53.79566428,48.59545572,-15.620025,-11.67494359,-14.4395118,305298300
306.100006,315.130005,298.799988,310.119995,11658600,173021905.6,-6.262205001,27689060.96,339.209991,310.119995,35.52748399,71.89938358,29592385.34,-80.86655623,41.62202571,-26.910004,-15.20056804,83.95922747,293639700
307,309.399994,297.380005,300.359985,6965200,143916363.1,-8.034448527,3550738.678,339.209991,300.359985,7.124028203,42.81498123,29225469.13,-92.51612667,39.0266284,-32.610016,-13.79370478,-9.236382591,286674500
306,318,302.730011,317.690002,7394100,125983320.9,-7.948946247,-12352791.94,339.209991,300.359985,48.55367869,30.4017303,29627343.68,-71.83097842,45.52241693,2.309997,-5.738360697,4.142253521,294068600
321.720001,336.73999,317.75,334.959991,7551200,239713844.2,-6.413708059,18451184.04,339.209991,300.359985,89.83982447,48.50584379,30029295.35,-42.92698524,51.11191083,15.190002,0.597648435,-8.738004883,301619800
341.959991,344.01001,327.019989,335.350006,7008500,184056896.5,-5.106683119,11666401.4,344.01001,300.359985,81.42825848,73.27392055,30038087.69,-28.19349853,51.23359926,39.959991,6.3320441,-22.74495971,308628300
335.5,343.5,331.470001,338.529999,5432900,90920360.9,-3.770790255,-21804125.69,344.01001,300.359985,88.24788674,86.50532323,30104546.55,-16.024204,52.27665294,12.440003,5.866720032,-32.23106476,314061200
334.399994,345.390015,331.790009,344.970001,6056400,115748009.2,-2.167446225,-25614714.51,345.390015,317.690002,99.01543844,89.56386122,30207898.95,-0.818740438,54.40362037,28.839996,16.78458427,8.930016727,320117600
342.089996,348.410004,338.769989,347.26001,5039100,121817193,-0.703885983,-22913877.43,348.410004,334.959991,96.24920466,94.50417662,30248103.05,-2.11707259,55.16877016,13.390015,6.492077114,-38.26977496,325156700
342.380005,342.5,334,334.399994,5247300,39279448.02,-0.575070705,-45987919.52,348.410004,334.399994,34.50210297,76.58891536,30061490.99,-25.79161991,50.08577701,1.600006,5.779264452,-38.8077107,319909400
335,348.799988,334.5,344.429993,6056600,55389649.67,0.332520338,-46120607.17,348.799988,334.399994,74.78362217,68.51164327,30218878.6,-7.987562857,53.67105394,34.309998,3.162907167,-39.06227991,325966000
344.779999,352,343.5,346.049988,4691700,66970715.17,1.169036907,-38297221.53,352,334.399994,70.55905666,59.9482606,30247365.26,-10.89346859,54.24273775,45.690003,3.981370336,-25.55574949,330657700
346.209991,351.5,344.149994,347.309998,3676700,18202000.38,1.911618642,-47132498.34,352,334.399994,73.94443333,73.09570405,30264448.31,-8.586602763,54.71084214,29.619996,11.99213324,-68.46362342,334334400
323,327.130005,299.730011,302.26001,24150800,48703100.39,-1.122102617,-36757261.73,352,302.26001,4.84025164,49.78124721,29787539.23,-91.06553378,39.25013863,-32.699981,0.632582599,246.7351978,310183600
304.820007,308,295.5,298.920013,12066700,71683714.62,-3.752600769,-21859263.88,352,298.920013,6.053120354,28.27926844,29520670.98,-93.94687965,38.38408824,-36.429993,-5.908271863,63.19362735,298116900
292.5,294.5,281.690002,287.589996,12530000,99670990.64,-6.674586709,-4872380.22,352,287.589996,8.391401177,6.428257724,29063304.76,-91.60859882,35.52086831,-50.940003,-14.14198599,65.9338913,285586900
283.029999,293.679993,279.279999,291.51001,8012200,163949867.2,-8.575120597,22972112.92,351.5,287.589996,16.93438221,10.45963458,29234095.74,-83.18205331,37.26451496,-53.459991,-13.07290747,14.32118142,293599100
294.390015,298.519989,289.549988,297.040009,7249600,149885438,-9.52528118,27799622.39,327.130005,287.589996,37.11600371,20.81392903,29386088.66,-75.57754434,39.74016556,-50.220001,-12.25592713,33.43886322,300848700
292.910004,297.459991,287.75,296.380005,6423300,107822213.6,-10.21380867,13863521.02,308,287.589996,59.54040879,37.86359823,29369980.51,-76.48514059,39.53961921,-38.019989,-14.08528158,6.05805429,294425400
295.269989,298.559998,291.799988,297.459991,4621700,80125465.12,-10.55070387,-1910533.255,298.559998,287.589996,94.29456921,63.65032723,29393386.52,-75.00001134,40.07254553,-46.970002,-14.34084478,-8.283225179,299047100
300.450012,309,298.48999,308.769989,11250300,140813641,-9.792195097,11120003.51,309,291.51001,99.22607338,84.35368379,29569112.4,-59.44720903,45.49120615,-37.279999,-7.664475317,114.4016923,310297400
301,311.559998,294,307.019989,12569200,275808031.6,-9.225931016,58392528.89,311.559998,296.380005,80.93234195,91.48432818,29505349.64,-61.85369964,44.81596473,-40.290009,-10.8614246,107.5289767,297728200
305.420013,316.100006,303.5,312.209991,7283400,221590906.7,-8.263120753,55171974.17,316.100006,296.380005,86.27860961,88.81234164,29717824.97,-54.7167333,47.31368395,9.949981,-9.778933152,55.24010487,305011600
312.980011,315.299988,301.880005,312.890015,7352100,140816133.2,-7.36036868,23137776.21,316.100006,297.459991,86.79017028,84.66704061,29733688.93,-53.7816068,47.64803642,13.970002,-9.910449799,99.96464221,312363700
312.48999,322.440002,312.25,321.350006,6742800,140264659.6,-5.894334371,7753973.97,322.440002,307.019989,96.16738424,89.74538804,29932476.67,-42.14795597,51.75037054,33.76001,6.315753116,-72.08042798,319106500
319.589996,324.23999,315.619995,317.220001,5038500,64596616.71,-5.008019178,-23320501.86,324.23999,307.019989,76.78574298,86.58109917,29845817.9,-47.46607384,49.70277556,25.709991,6.122035061,-58.24459048,314068000
313.299988,314.700012,303,307.51001,6520600,29359225.14,-5.031127421,-45124639.12,324.23999,307.51001,25.17893013,66.04401912,29691591.21,-41.00311921,45.17692518,10.470001,6.926532312,-47.96009577,307547400
306.829987,307.450012,298.5,305.799988,5844200,66986023.74,-5.128309396,-37970110.34,324.23999,305.799988,28.36049276,43.44172196,29655331.03,-41.01424753,44.40997416,9.419983,4.902053964,-27.05873543,301703200
311.600006,318.600006,310.5,312.839996,7129700,53198608.84,-4.584410768,-35978334.19,324.23999,305.799988,55.71096181,36.4167949,29789873.92,-25.35586362,48.30120934,15.380005,5.319144398,-1.653884352,308832900
316.200012,318.190002,309.619995,311.809998,5517600,19589398.68,-4.188200449,-42586598.62,324.23999,305.799988,51.70941403,45.26028953,29766400.02,-27.64678489,47.77430366,3.040009,5.206151812,-14.10022885,303315300
312.350006,312.75,305.570007,308.170013,5141600,18064400.82,-4.120419653,-41903697.14,318.600006,305.799988,48.10950305,51.84329297,29701989.06,-44.0394119,45.86993554,1.150024,3.600491604,11.24910747,298173700
303.380005,306.769989,301,303.769989,5200800,21790555.86,-4.371357757,-36629306.56,318.600006,303.769989,26.21884292,42.01258667,29628577.75,-56.09757909,43.60709561,-8.440002,-1.61932836,-53.77189942,292972900
304.5,308,303.899994,307.880005,3904900,27129358.3,-4.190281117,-29442954.49,318.600006,303.769989,39.09092417,37.80642338,29698944.71,-50.43151662,46.27327416,-5.01001,0.280117266,-68.93278809,296877800
306.559998,311.540009,305.470001,305.640015,4168400,12084298.61,-4.179348125,-28613515.41,318.190002,303.769989,26.99252158,30.76742956,29670534.5,-61.50787418,45.02389269,-15.709991,-2.104345213,-42.76848724,292709400
304.410004,306.299988,299,302.559998,7142100,18423800.68,-4.368853853,-23655856.46,312.75,302.559998,25.89089455,30.65811343,29628528.4,-71.69311895,43.29298436,-14.660003,-3.301485028,-2.856326764,285567300
301.809998,303.23999,290.5,291.230011,8909200,19871880.05,-5.371356121,-19016438.32,311.540009,291.230011,3.469632546,18.78434956,29361077.65,-97.83636273,37.57102174,-16.279999,-9.372956103,32.12908584,276658100
294.48999,296.5,292.100006,294.709991,5740600,10752602.37,-5.817975092,-18291315.77,311.540009,291.230011,20.00945437,16.45666049,29467535.9,-87.52225178,40.18596697,-11.089997,-7.096024818,13.93470279,282398700
297.910004,302.899994,297,298.769989,6626500,19737756.29,-5.777714046,-13472915.22,311.540009,291.230011,39.30601456,20.92836716,29546619.83,-75.48905913,43.17643133,-14.070007,-2.842190731,1.624083673,289025200
292.220001,302.01001,288.769989,297.859985,8582500,82415016.44,-5.752920508,9665823.704,306.299988,291.230011,51.85394477,37.05647123,29526436.61,-74.37272133,42.66158843,-13.950013,-2.596469363,46.85500154,280442700
301.779999,316.299988,300.549988,314.73999,11183900,232916570.8,-4.321381918,66139818.4,316.299988,291.230011,94.33346147,61.83114027,30012814.94,-12.94003956,53.69212816,6.569977,0.607337305,56.86354265,291626600
318.920013,320,310.809998,319.880005,10520700,252877278.7,-2.740529896,89581239.8,320,294.709991,99.61577023,81.93439216,30195459.08,-0.384229772,56.44011309,16.110016,2.588116818,90.67529361,302147300
306.940002,307.130005,291.899994,294.790009,22911400,142935961.5,-3.472220672,56045834.93,320,294.790009,19.27639411,71.0752086,29370261.14,-80.72360589,43.02012614,-13.089996,-4.341760533,345.6083709,279235900
298.119995,299,282.779999,285.359985,17096800,77382665.02,-4.758165836,16373862.69,320,285.359985,6.931719319,41.94129455,28637349.42,-93.06828068,39.2433029,-20.28003,-6.06050784,228.7340409,262139100
282,284,270.100006,276.540009,18764700,140506049.2,-6.415036448,18740599.67,320,276.540009,12.90581919,13.03797754,28108917.36,-87.09418081,36.05499868,-26.019989,-10.17928917,380.5423955,243374400
276.480011,281.51001,274.390015,276.23999,10335500,122244263.4,-7.66398176,12194551.17,320,276.23999,12.30457863,10.71403905,28088559.48,-87.69542137,35.94801067,-14.990021,-9.619167503,147.9488533,233038900
278.839996,284.700012,274.25,276.589996,9442500,26237673.59,-8.527240637,-22139524.62,307.130005,276.23999,17.52630347,14.2455671,28101654.93,-86.99400645,36.1859124,-18.119995,-8.583422188,32.20901416,242481400
276.910004,285.589996,275.890015,284.140015,8819600,86210624.2,-8.504125812,-15090296.38,299,276.23999,48.58135611,26.13741274,28359404.87,-71.86370604,41.25460593,-14.629974,-2.434500475,-1.005701971,251301000
283.519989,291.279999,280.5,290.920013,7392300,148224325.4,-7.848248251,8896956.138,291.279999,276.23999,98.30034882,54.80266947,28569853.48,-58.27653406,45.44522731,-6.939972,-1.28600255,28.77225377,258693300
286.48999,288.070007,281.059998,283.359985,7504100,88998335.43,-7.848024495,-943524.2866,291.279999,276.23999,53.49374947,66.79181813,28377752.58,-73.4268926,41.85950074,-31.380005,-5.157815232,13.24379386,251189200
283.899994,291.98999,282.700012,288.959991,6844700,52832556.73,-7.311688885,-16390693.66,291.98999,276.589996,82.91995091,78.2380164,28526055.12,-62.20443433,45.30227035,-30.920014,-2.987979067,-20.24817943,258033900
292.450012,295.390015,288.290009,289.959991,7103400,47045156.25,-6.728386754,-23061372.77,295.390015,283.359985,72.15372308,69.52247449,28549742.48,-60.20042608,45.91812348,-4.830018,-7.873165085,-36.4854836,265137300
283.51001,283.720001,274.399994,275.429993,14785500,8507497.687,-7.353795047,-35955780.78,295.390015,275.429993,4.907088945,53.32692098,28193788.59,-89.31866204,39.04002793,-9.929992,-13.89583947,40.53722661,250351800
276,278.049988,267.299988,269.48999,10281000,16406434.61,-8.233829761,-35448760.43,295.390015,269.48999,7.796368441,28.28572682,27874920.21,-95.84439943,36.62476345,-7.050019,-8.582386861,-55.12714195,240070800
267.5,273.299988,263.459991,267.470001,11800600,54657789.17,-8.990621553,-19847842.88,295.390015,267.470001,12.55874408,8.420733823,27797857.96,-92.90765942,35.81334207,-8.769989,-6.269268622,-30.97772683,228270200
269.690002,274.970001,266.299988,273.600006,6908200,89667304.63,-8.992089122,-521908.7039,295.390015,267.470001,31.75699148,17.37070133,28068309.73,-76.78037154,40.14699463,-2.98999,-1.06313839,-63.18512953,235178400
272.600006,276.450012,268.450012,274.019989,5947100,80657144.31,-8.857262059,4564732.33,283.720001,267.470001,52.12237309,32.14603622,28078914,-70.28701371,40.4436777,-10.120026,-0.803649392,-42.4594843,241125500
272.579987,272.799988,264,264.529999,8745600,27735044.11,-9.4077271,-10608194.8,278.049988,264.529999,7.333846607,30.40440372,27872951.21,-96.64889698,36.09039238,-26.390014,-4.360243383,-7.380460683,232379900
259.709991,263.179993,254.460007,260.420013,10215000,54064574.07,-10.0596547,-7473342.287,276.450012,260.420013,27.10324986,28.85315652,27737071.38,-85.43854182,34.36517311,-22.939972,-8.347997729,15.82157921,222164900
264.440002,270.26001,264.429993,267.769989,7350900,79060672.51,-9.869461368,2441796.179,276.450012,260.420013,60.52741689,31.65483779,28025374.89,-67.48111557,39.89828931,-21.190002,-7.957521987,-0.560042206,229515800
268.75,275.369995,268.179993,274.829987,8779200,79134643.02,-9.044786284,6299543.789,276.450012,260.420013,92.63290299,60.08785658,28219188.02,-50.23216218,44.71903685,-15.130004,-3.010304366,16.99204435,238295000
277.160004,280.329987,275.100006,278.619995,6774100,79352163.07,-7.993262018,7374238.39,280.329987,260.420013,93.39005287,82.18345758,28340256.46,-40.97243274,47.16887636,3.190002,-3.578348672,-1.031454994,245069100
278.700012,280.160004,274.5,279.859985,5991300,53425599.27,-6.979410333,-1105860.335,280.329987,260.420013,98.18321468,94.73539018,28370404.39,-37.9428951,47.98111899,10.369995,-3.483241245,-15.6558831,251060400
282.619995,289.200012,281.279999,289.179993,8110400,95847309.28,-5.362068229,9023357.947,289.200012,267.769989,99.91918052,97.16414936,28569929.03,-15.17229608,53.73818706,21.709992,4.992194151,-45.14625816,259170800
288.299988,289.440002,283.880005,285.880005,5478900,71501339.51,-4.297060572,4600378.867,289.440002,274.829987,83.25496005,93.78578508,28477376.91,-23.234811,51.56221804,12.279999,6.081864117,-46.70849139,253691900
287.320007,296.170013,287.170013,291.809998,7929900,40402736.24,-2.940635638,-7522248.058,296.170013,278.619995,79.87996131,87.68470063,28591025.43,-10.45316321,55.08200639,17.790009,9.100084835,-32.80087453,261621800
261.890015,271.200012,260.589996,267.779999,23720700,195858825.3,-3.76132103,37665637.27,296.170013,267.779999,20.20798079,61.11430072,27938013.23,-68.06523595,41.82020047,3.25,-2.127195494,243.3701977,237901100
269.859985,276.100006,266.109985,274.959991,13038300,276806980.2,-3.788681209,78483672.61,296.170013,267.779999,40.387825,46.8252557,28574036.97,-50.85116027,46.00345044,14.539978,0.343041398,119.2379479,250939400
277.690002,281.160004,270.440002,273.200012,10410400,134903869.6,-3.907338577,42896090.74,296.170013,267.779999,35.44128717,32.01236432,28490580.7,-55.07072092,45.14654224,5.430023,3.277515984,19.03585803,240529000
271.649994,275,269.609985,272.309998,5904000,33997066.44,-4.026773944,-7668820.188,296.170013,267.779999,32.93984373,36.25631863,28456666.35,-57.20453505,44.6931657,-2.519989,4.565695571,-42.20264317,234625000
276.73999,278.380005,272.890015,276.059998,7061300,32394535.89,-3.775314201,-28167196.18,281.160004,267.779999,75.20659204,47.86257432,28537970.74,-48.21388662,47.10351762,-2.559997,3.095944034,-3.939653648,241686300
268.299988,270.5,265.600006,268.420013,9835900,42962264.97,-4.144735551,-30629782,281.160004,268.420013,18.12344063,42.0899588,28342548.64,-66.53079839,42.99257828,-11.439972,-2.332341558,12.03640423,231850400
270.220001,271.950012,266.829987,267.700012,6746000,23831597.61,-4.444370757,-34939708.36,281.160004,267.700012,13.49618425,35.60873898,28316165.14,-80.01682799,42.61511331,-21.479981,-3.919310601,-0.414815252,225104400
268.630005,268.880005,258.630005,266.380005,10038600,75620219.94,-4.733779288,-17048324.91,278.380005,266.380005,39.24050633,23.62004374,28282901.16,-79.35535869,41.8889892,-19.5,-4.816687173,67.55295178,215065800
265.75,275,264.720001,273.359985,7272900,137028171.8,-4.34977014,11359618.9,278.380005,266.380005,74.58217722,42.4396226,28545943.53,-60.76191566,47.02882717,-18.450013,-5.470644022,-10.32624778,222338700
274.75,274.790009,268.540009,271.230011,5126500,72547703.31,-4.169250697,1431845.13,275,266.380005,76.97012736,63.59760363,28489274.35,-66.43579298,45.70046522,3.450012,-5.124525585,-6.431948019,217212200
271.230011,274.839996,269.75,273.26001,5876300,29672051.58,-3.818368015,-16401937.43,275,266.380005,89.37085809,80.30772089,28527643.22,-61.02823153,47.23029514,-1.699981,-6.356871981,-25.89692178,223088500
269,269.679993,262.480011,262.75,12147100,10389791.3,-4.338351121,-28341755.16,275,262.75,25.16796737,63.8363176,28301631.47,-89.02505562,40.81829032,-10.450012,-1.878407282,-48.79114023,210941400
260.149994,265.600006,255.75,263.899994,10943900,78891894.44,-4.604567981,-8853579.128,275,262.75,42.33763117,52.29215221,28354796.43,-79.83673583,41.7501386,-8.410004,-4.022402299,-16.06344385,221885300
263.850006,265.320007,258,258.660004,10727500,84623843.68,-5.178673634,1747529.383,274.839996,258.660004,15.24360718,27.58306857,28137494.69,-88.54780188,38.75571639,-17.399994,-5.32211104,3.045992469,211157800
255,259,246.070007,247.630005,21849400,12191672.31,-6.449341248,-17121119.79,274.839996,247.630005,5.422310033,21.00118279,27680043.55,-95.55429429,33.33576666,-20.790008,-9.063197525,270.0779133,189308400
246.5,246.679993,231.130005,235.139999,22360700,87943637.94,-8.36773554,819250.9571,269.679993,235.139999,10.4020629,10.35599337,26577999.65,-91.98482095,28.47891551,-32.560013,-14.82286434,216.6654865,166947700
235.860001,243.979996,232.169998,241.470001,16714500,224964441.7,-9.270434777,51681544.65,265.600006,235.139999,29.99708645,15.2738198,27179952.85,-78.11641058,33.74725897,-24.910004,-10.04023944,69.93361055,183662200
242.059998,244.210007,237,238.690002,9464600,160641608.8,-10.09379809,47324168.44,265.320007,235.139999,22.11171851,20.83695595,26987521.94,-84.00000635,32.6111207,-34.669983,-10.83676081,40.2994367,174197600
238.850006,240,231.5,234.009995,10704400,28073594.67,-10.99718816,-941323.4476,259,234.009995,10.33365812,20.81415436,26801949.05,-93.43517135,30.73519675,-37.220016,-12.15181673,6.63239894,163493200
245.520004,247.130005,237.720001,244.100006,18159300,129333703.7,-10.77474716,11618403.07,247.130005,234.009995,81.06250625,37.83596096,27263499.9,-70.4353716,38.89626621,-29.160004,-10.70382668,149.684445,181652500
243.860001,256.609985,243.490005,255.029999,23706800,380730589.2,-9.60577261,95690172.64,256.609985,234.009995,93.70773818,61.70130085,28076613.45,-45.52086455,46.28011017,-7.720001,-5.972794803,362.4363601,205359300
250.020004,258.350006,248.5,255.339996,10833900,341514575.8,-8.555712757,108906240.2,258.350006,234.009995,88.78953696,87.85326046,28105429.81,-44.81423807,46.47765796,-8.559998,-6.557861869,84.36601263,216193200
256.799988,257.209991,245.100006,247.059998,10131400,82158982.27,-8.296027952,21890011.75,258.350006,234.009995,57.95156247,80.14961253,27754115.21,-63.55525903,42.03164375,-11.600006,-5.971456518,-16.59408418,206061800
246.940002,250.600006,244.199997,244.839996,6176400,9759950.439,-8.175123744,-38733592.92,258.350006,244.100006,34.51281277,60.41797073,27663077.69,-68.63419395,40.90190515,-2.790009,-7.222432146,-43.5630808,199885400
242,243.679993,236.940002,241.979996,6711400,30526758.1,-8.21538257,-53405302.12,258.350006,241.979996,23.54036926,38.66824817,27590930.56,-71.8547487,39.43148295,6.839997,-6.448622803,-37.43742717,193174000
239.75,241.990005,236.020004,239.520004,7008300,53762098.01,-8.349540469,-47159274.81,258.350006,239.520004,15.67397979,24.57572061,27522701.82,-75.65999781,38.16071185,-1.949997,-3.275047788,-67.92451967,186165700
232.009995,232.470001,224.5,227.009995,10834800,41402168.81,-9.357447912,-44249579.77,257.209991,227.009995,7.67348117,15.62927674,27156661.84,-93.85106671,32.43592731,-11.680007,-3.457516388,-51.54534518,175330900
229.300003,234.5,228,232.309998,7252400,48587027.24,-9.617689141,-36750469.59,250.600006,227.009995,29.92335711,17.75693935,27409621.95,-77.36232464,36.76414644,-1.699997,-3.793433123,-56.61012893,182583300
229.320007,232.440002,225.25,231.949997,7296000,77200275.6,-9.740696574,-21237484.62,243.679993,227.009995,38.84254285,25.47979371,27398383.21,-77.99115013,36.59267184,-12.150009,-2.823748353,-22.91274856,175287300
229.490005,231,226.5,228.330002,7483300,57640315.21,-10.01483936,-19184206.84,241.990005,227.009995,21.89823273,30.22137756,27284516.07,-88.68537276,34.83329514,-26.699997,-2.427243759,-30.0913643,167804000
221.960007,222.240005,208.919998,211.029999,17786700,31815183.44,-11.49555159,-24817298.14,234.5,211.029999,8.248635008,22.9964702,26717524.82,-95.73133591,27.92359838,-44.309997,-13.54772888,-2.051841205,150017300
202.800003,206,195.25,205.360001,20526200,228858697,-12.97695786,37830036.83,234.5,205.360001,25.75796433,18.63494402,26239628.06,-83.97781293,26.09647574,-41.699997,-19.47613935,-13.41640373,129491100
197.759995,207.399994,196.039993,205.080002,18003900,365376457.7,-14.01205434,103456867.1,232.440002,205.080002,26.43184047,20.1461466,26211641.52,-84.4215514,26.00598007,-39.759994,-19.68355713,66.1811536,111487200
199.100006,203.940002,191.779999,192.729996,18685200,159604038.4,-15.6485315,55425994.54,231,192.729996,2.422225843,18.20401022,25127438.91,-98.57293541,22.3281326,-49.25,-21.99061056,84.42860809,92802000
194.339996,199.470001,186.220001,195.490005,26547100,238643043.7,-16.53216923,55887048.82,222.240005,192.729996,25.73571063,18.19659232,25395022.17,-87.14819998,24.88481193,-44.029999,-20.15601691,329.8151026,119349100
199.830002,199.979996,188.75,190.630005,14136600,252924459.5,-17.4237695,55539107.98,207.399994,190.630005,20.82155551,16.32649733,24735045.17,-93.78785094,23.42276558,-36.37999,-21.22075868,110.6356349,105212500
191.199997,195,187.850006,188.699997,10312900,14485845.35,-18.077716,-25519073.03,207.399994,188.699997,11.70914457,19.42213691,24591921.06,-96.14787852,22.84865579,-43.610001,-21.21743744,47.15266184,94899600
187.100006,192.389999,185.039993,189.860001,11968600,53247919.88,-18.29151746,-44025934.91,203.940002,188.699997,25.50267569,19.34445859,24655318.01,-91.78034106,24.0535511,-42.089996,-16.36491556,10.46442943,106868200
188.75,192.259995,187.020004,188.220001,7926500,56969454.37,-18.3814016,-46410441.53,199.979996,188.220001,21.28518984,19.49900336,24551933.92,-94.41614165,23.49489019,-40.110001,-18.97894941,9.294854117,98941700
185.100006,189.919998,184.100006,185.160004,10406700,5920262.374,-18.4864513,-59409715.19,199.979996,185.160004,6.675054581,17.82097337,24423068.41,-97.89682911,22.44729169,-25.869995,-20.1724482,42.63569079,88535000
185.509995,186.679993,176.990005,178.970001,13064400,17992322.1,-18.8518728,-55485606.75,195,178.970001,10.99387312,12.98470585,24075166.58,-96.55712716,20.45991657,-26.39,-21.61783409,74.5807331,75470600
181.100006,193.979996,179.610001,193.600006,13807500,208274441.8,-17.75626962,11708167.21,193.979996,178.970001,97.7634479,38.47745854,25143123.42,-70.04508224,35.08777348,-11.479996,-8.259485894,-22.37177217,89278100
198.679993,201.279999,191.850006,196.589996,13510800,250123344.5,-16.45702269,51447710.41,201.279999,178.970001,80.69162553,63.14964885,25356368.7,-63.7104373,37.61299087,3.86,-4.270551693,-34.17778254,102788900
204.440002,211,201.800003,205.949997,20242200,130215257,-14.50488301,24875158.37,211,178.970001,85.15141505,87.86882949,25999642.03,-36.00001768,44.84631082,10.459992,0.424222251,12.43230633,123031100
205,210.839996,203.5,204.5,16003500,75074105.25,-12.92580031,-5801721.044,211,178.970001,80.88797132,82.24367063,25857126.23,-19.11202868,43.99531807,13.869995,6.106991254,-14.35200051,107027600
210.25,216.940002,209.009995,212.880005,10585000,37725072.75,-10.87283427,-29707707.42,216.940002,193.600006,89.12403726,85.05447454,26512917.97,-10.16269663,49.91098227,24.180008,8.895595455,-60.12747155,117612600
219.139999,220.899994,213.5,217.100006,11653500,71513212.44,-8.803839883,-26035956.72,220.899994,196.589996,86.9191409,85.64371649,26722748.43,-8.654039973,52.62481488,27.240005,13.88553759,-17.56504393,129266100
222.949997,223.380005,209,209.259995,15186200,25005161.56,-7.707918211,-36964987.92,223.380005,204.5,34.56900514,70.2040611,26301912.11,-30.43761587,47.47817949,21.039994,10.8956006,47.25440953,114079900
210.380005,214.899994,207.509995,213.910004,8168300,40219646.93,-6.390509708,-33234529.17,223.380005,204.5,52.36419206,57.95077936,26639367.75,-20.41388446,50.5661896,28.75,12.66723,-31.75225173,122248200
211.25,216.649994,210.399994,214.919998,7433400,82724376.97,-5.204956406,-15162879.28,223.380005,209.259995,46.69186094,44.54168605,26677935.07,-18.23670403,51.23681605,35.949997,14.1855259,-6.220904561,129681600
215.479996,227,214.270004,225.029999,12316800,162164086,-3.410292554,18884783.01,227,209.259995,89.8922499,62.98276763,27027607.88,-3.939214551,57.45823173,31.429993,21.53272529,18.35452161,141998400
228.720001,234.740005,222.559998,224.740005,12715800,147903286.1,-1.988486579,26559046.46,234.740005,209.259995,63.27581224,66.61997436,27011735.34,-17.31601732,57.2326709,28.150009,25.57412066,-2.668320015,129282600
225.110001,227.770004,221.059998,226.429993,6575100,51275821.84,-0.717061355,-3461043.178,234.740005,213.910004,69.4821559,74.21673935,27107354.94,-14.38963117,58.26100145,20.479996,16.95763739,-52.38022814,135857700
223,226.899994,216.350006,219.619995,11863500,64602313.37,-0.256006546,-11187101.34,234.740005,214.919998,37.88001986,56.87932933,26909605.44,-26.1818355,52.75619425,15.119995,11.71473598,-12.19246825,123994200
216.220001,222.179993,215.5,221.860001,8202100,82379587.71,0.286826122,-7674346.82,234.740005,219.619995,37.07863522,48.14693699,27030606.77,-23.36296584,54.2862181,8.979996,7.725178068,-59.48019484,132196300
223.240005,225.860001,221.020004,223.639999,5750800,64201758.24,0.850847841,-11323497.82,234.740005,219.619995,42.30767612,39.08877706,27096412.78,-25.88017314,55.5189907,6.539993,9.359412714,-64.0653607,137947100
224.389999,225.339996,219.490005,219.759995,6182100,8201622.341,0.973532939,-29605148.48,227.770004,219.619995,34.71877434,38.03502856,26996640.26,-45.47665176,52.21364294,10.5,3.231862946,-41.59565423,131765000
220.309998,227.229996,218.100006,219.270004,8507200,-1691282.113,1.019471748,-37540370.76,227.229996,219.270004,32.13985751,36.38876932,26982856.25,-49.51984163,51.79427237,5.36,0.999538434,-26.99875574,123257800
219.449997,222.899994,217.350006,222.839996,6339700,37272749.59,1.328631468,-24976190.63,227.229996,219.270004,62.57458229,43.14440471,27121364.19,-43.70181649,54.65209334,7.919998,6.489535183,-58.25354598,129597500
220.990005,225.169998,220.800003,223.460007,6851400,50280134.28,1.605169089,-13427022.66,227.229996,219.270004,61.84217798,52.18553926,27139003.23,-41.42487645,55.14939682,-1.569992,4.464495733,-16.12208171,136448900
230.210007,233.100006,226.279999,227.169998,8238000,15712636.21,2.099490792,-18480474,233.100006,219.270004,62.34915556,62.25530528,27252753.48,-27.80023584,58.10969796,2.429993,5.699795326,10.82411817,144686900
228.889999,229.149994,222.220001,224.550003,9259000,15596405.54,2.253851603,-18904734.4,233.100006,219.270004,45.71426667,56.63520007,27157743.05,-37.42195467,55.33217513,-1.87999,-0.213303116,-24.82625357,135427900
239.389999,241.570007,234.509995,234.899994,14201100,7549340.651,3.174744951,-19920112.99,241.570007,222.839996,72.46072368,60.1747153,27584510.21,-21.39881366,62.88027967,15.279999,4.520774572,11.68074364,149629000
234.570007,235.449997,230.800003,233.100006,7065700,4802094.113,3.716474371,-19398699.68,241.570007,223.460007,59.22003193,59.13167409,27475690.25,-31.02564128,60.95124513,11.240005,2.945728572,7.461483476,142563300
231.240005,232.25,228.660004,230.339996,5880500,19430862.99,3.878381531,-12767267.8,241.570007,224.550003,41.96378544,57.88151368,27392029.15,-43.07636358,58.01242962,6.699997,4.881158931,-50.4319973,136682800
228.970001,231,227.279999,230.059998,6190800,22396633.32,3.938697768,-7950094.398,241.570007,224.550003,40.5167678,47.23352839,27384880.9,-44.15038707,57.7084405,10.300003,3.696023151,-24.52176882,130492000
234.149994,238.940002,233.139999,238.919998,9145700,68476666.63,4.64784926,9405132.083,241.570007,230.059998,81.45551073,54.64535466,27623299.08,-10.16497234,64.1161084,19.649994,6.832408813,59.03352577,139637700
238.139999,241.5,235.800003,238.600006,7514400,70047826.32,5.124958911,16149899.9,241.5,230.059998,79.6062321,67.19283688,27611050,-11.39240584,63.74048577,15.76001,8.572993915,21.5509293,132123300
239.75,245.380005,239.710007,245.080002,9200500,66137067.67,5.957281436,16196618.08,245.380005,230.059998,98.34252541,86.46808941,27815129.13,-1.070292582,67.84828354,21.619995,11.77087496,8.149567425,141323800
248,254.419998,244.860001,253.5,11000100,142902103,7.213177483,39168548.74,254.419998,230.059998,96.61017674,91.51964475,28131222.62,-2.481786346,72.24781292,26.330002,13.75875272,73.51136489,152323900
249.300003,253.529999,247.929993,252.380005,8149000,128571970.9,8.02559584,40445792.1,254.419998,238.600006,90.41356628,95.12208948,28082622.79,-5.503084543,70.85886792,27.830002,12.94191224,18.93919491,144174900
255.669998,258.309998,253.350006,254.860001,9764700,42542367.25,8.768480605,9918354.858,258.309998,238.600006,84.67348838,90.5657438,28162698.41,-8.422845883,72.13624625,19.960007,12.18911091,18.53241078,153939600
255.050003,255.75,251.889999,253.539993,4764500,13086191.38,9.145287341,-12844230.42,258.309998,245.080002,74.35479942,83.14728469,28112123.66,-12.71662393,70.36817533,20.439987,12.91026035,-48.54195917,149175100
255.690002,259.959991,254.619995,258.179993,7048400,27876351.2,9.706428944,-16282579.87,259.959991,252.380005,88.21192597,82.41340459,28199318.11,-4.716477137,72.88409276,27.839997,9.910600083,-50.36722507,156223500
258.75,262.149994,254.190002,255.679993,6842400,27376333.09,9.836025027,-16368039.51,262.149994,252.380005,54.5006994,72.35580826,28131067.27,-16.20336122,69.46199845,25.619995,9.68682386,-3.160337971,149381100
256.709991,260.480011,254.5,260.170013,5023100,32854158.62,10.1836472,-13172052.19,262.149994,253.539993,80.70193017,74.47151851,28251227.29,-5.678179765,72.00438823,21.250015,12.95042872,-14.58039282,154404200
259.170013,266.070007,258.160004,264.880005,11072800,100964055.1,10.71567365,11004187.15,266.070007,253.539993,91.60788908,75.60350622,28342163.06,-3.067805503,74.41102723,26.279999,15.1351853,78.85895199,165477000
233.5,234.5,225.550003,228.820007,22418300,131823869.1,8.133806518,29713117.96,266.070007,228.820007,8.07009792,60.12663906,26834744.09,-91.92990208,43.54629928,-16.259995,-4.227352706,145.123938,143058700
226.919998,230.259995,222.25,228.039993,10027700,114361559.5,5.956059852,29109389.51,266.070007,228.039993,13.2131266,37.6303712,26758323.38,-86.7868734,43.12956273,-25.460007,-4.425822605,33.44644948,133031000
227.089996,235.940002,226.029999,235.770004,9273300,145444008.3,4.798611804,36105971.64,266.070007,228.039993,30.85349576,17.37890676,27098238.45,-69.14650424,48.39973342,-16.610001,-3.798758742,0.791261344,142304300
232.899994,243.360001,232.179993,242.259995,8109000,171103800.6,4.354814333,43850328.07,266.070007,228.039993,45.66406162,29.91022799,27353502.62,-54.33593838,52.38900868,-12.600006,-4.433927022,-26.28248834,150413300
243,246.679993,236.649994,241.610001,9178200,121825402.1,3.905630874,27352589.99,246.679993,228.039993,79.24685447,51.92147062,27331745.82,-55.81926539,51.95577143,-11.929992,-4.267376094,12.62977052,141235100
242.649994,244.509995,231.770004,233.850006,8259500,51153282.56,2.890166958,-4369667.245,246.679993,228.039993,47.48264152,57.46451921,27036961.72,-73.52805991,46.96262031,-24.329987,-8.243739668,-15.41470808,132975600
231.350006,236.270004,229.229996,234.339996,6136500,39943970.97,2.100726717,-20516310.96,246.679993,233.850006,40.24212792,55.65720797,27054268,-72.40987205,47.30697382,-21.339997,-7.572768609,28.79630601,139112100
229.600006,231.369995,225.779999,228.320007,7028300,43692391.8,0.978052457,-24063957.58,246.679993,228.320007,12.15315181,33.29264042,26896626.69,-86.14786392,43.5645827,-31.850006,-11.5655693,-0.285171103,132083800
231.880005,232.5,225.75,230.75,5564200,40395619.02,0.28116406,-24376608.22,246.679993,228.320007,23.88916231,25.42814735,26971428.37,-80.60246773,45.44081199,-34.130005,-9.750466866,-18.68057991,137648000
226.5,233.570007,225.800003,233.419998,4776500,62683119.84,-0.055043979,-15196977.92,244.509995,228.320007,40.88486164,25.64239192,27035811.48,-74.50936509,47.5058849,4.599991,-10.28174411,-4.909318946,142424500
234.449997,239.800003,232.649994,238.300003,5274300,64998037.57,0.071460595,-9323566.442,239.800003,228.320007,89.3238457,51.36595655,27135671.58,-63.3728881,51.14558283,10.26001,-10.03473327,-52.36706163,147698800
236.050003,238.960007,233.809998,235.009995,3898200,30381290.25,-0.092691281,-17087629.85,239.800003,228.320007,65.90742365,65.37204366,27062853.75,-70.88089237,48.69429572,-0.760009,2.705177786,-82.61152719,143800600
232.990005,235.770004,228.75,229.009995,4663900,-1590632.809,-0.698876469,-28883301.32,239.800003,229.009995,23.20280643,59.47802526,26963329.47,-84.5732681,44.50506333,-13.25,0.425364861,-53.48983316,139136700
228.809998,236,227.550003,235,4848100,32266014.9,-0.688008323,-20310478.9,239.800003,229.009995,65.71426429,51.60816479,27085318.84,-47.81005463,49.20347419,-6.610001,-0.326591164,-47.7197977,143984800
231.210007,231.5,216.690002,219.619995,9562600,55892195.47,-1.898547828,-7439586.914,239.800003,219.619995,12.67846332,33.86517801,26768026.06,-90.2300971,39.86974729,-14.230011,-9.345331655,17.9257615,134422200
220.860001,221.559998,211.550003,215.639999,8159600,48894677.09,-3.142832902,-3724379.051,238.960007,215.639999,14.9215447,31.10475744,26594730.78,-88.35753725,37.86785429,-18.699997,-10.74872807,-11.09803665,126262600
216.660004,222.240005,216.020004,219.940002,5098500,46647882.44,-3.738864183,-2580830.581,236,215.639999,34.31492855,20.63831219,26757438.55,-76.11727473,41.29731737,-8.380005,-5.948258988,-38.27108178,131361100
224.210007,227.830002,221.699997,226.830002,5309600,44472919.08,-3.613602489,-2570428.133,236,215.639999,62.4948911,37.24378812,26917157.86,-56.50440265,46.40226578,-3.919998,-3.204742736,-13.47510796,136670700
227.619995,229.089996,224.539993,225.860001,4125200,28888973.64,-3.551661327,-7291025.395,231.5,215.639999,71.72932407,56.17971457,26894452.24,-56.58373339,45.79842616,-7.559997,-1.077437774,-41.30586344,132545500
222.009995,223.220001,217.600006,220.830002,7794300,24377763.22,-3.863910636,-9994743.466,229.089996,215.639999,52.90765509,62.37729009,26802582.26,-67.15044602,42.69567662,-17.470001,-4.299024052,40.0794364,124751200
222.800003,225.399994,218.220001,222.149994,6559000,44668812.94,-3.959218731,-3735953.813,229.089996,219.940002,46.90125289,57.17941068,26849172.01,-62.47790796,43.77222888,-12.860001,-4.828208421,37.31811996,131310200
219.970001,221.169998,211,211.399994,8538600,18020533.11,-4.846320871,-9314905.826,229.089996,211.399994,2.211133712,34.00668056,26531777.22,-98.61113209,37.58025274,-17.610001,-11.2882957,61.89067744,122771600
213.600006,215.020004,211.539993,215,5051900,12663188.35,-5.198935221,-12455004.46,229.089996,211.399994,22.11166879,23.7413518,26677184.09,-86.11111256,40.61011271,-20,-8.51452935,29.59571084,127823500
215.740005,218.800003,212.029999,214.080002,5416200,24777657.98,-5.489343054,-8752713.15,225.399994,211.399994,21.38891169,15.23723806,26655566.71,-89.30554973,40.07476022,-5.539993,-6.519363052,16.13027724,122407300
213.690002,217.25,212.309998,215.589996,3225500,16822847.15,-5.533858581,-8973514.414,225.399994,211.399994,31.8749855,25.12518866,26693769.39,-83.5837094,41.43929605,-0.050003,-8.25957617,-33.46878158,125632800
219,223.399994,218,221.710007,5179500,27090759.16,-5.017465497,-4981005.251,223.399994,211.399994,86.37106599,46.54498773,26785332.52,-57.159972,46.73339266,1.770005,0.951649234,-45.83586054,130812300
229.149994,232.440002,224.210007,225.610001,9320600,22908699.77,-4.244594295,-4225542.652,232.440002,214.080002,67.32058345,61.85554498,26876442.61,-41.559996,49.84507718,-1.220001,4.623447434,14.22863866,140132900
224.080002,228.949997,223.160004,225.009995,5354100,11575352.87,-3.638560706,-7138414.453,232.440002,214.080002,63.59624739,72.42929894,26851654.63,-34.65488016,49.36726641,-0.850006,2.305170935,5.013239188,134778800
226.889999,228.460007,219.210007,220.679993,5761000,9884765.875,-3.46769625,-8219011.1,232.440002,215.589996,41.57969864,57.49884316,26748622.48,-54.85078313,45.94444775,-0.150009,-2.71128552,8.50158204,129017800
222.5,229.800003,220.850006,229.580002,7395300,68002267.14,-2.584337953,10578041.68,232.440002,220.679993,80.19390856,61.78995153,26980963.22,-13.33955099,53.13669712,7.430008,1.647038424,79.27130806,136413100
227.199997,229.639999,225.169998,227.449997,4189400,71878456.18,-2.032711903,18539437.82,232.440002,220.679993,62.28263881,61.352082,26912350.85,-23.27427488,51.37492203,16.050003,2.997778807,-46.25046508,132223700
230,233.759995,229.229996,231.789993,4802700,17705605.18,-1.231150937,2874152.937,233.759995,220.679993,86.46045619,76.31233452,26992289.21,-8.655546717,54.6726132,16.789993,4.339409975,-26.77694771,137026400
230.800003,235.539993,228.940002,235.539993,4883700,42438679.67,-0.289971821,4073955.281,235.539993,220.679993,100,82.914365,27069989.4,0,57.36328092,21.459991,11.41911054,-42.80444101,141910100
237.380005,248.169998,236,247.100006,10042800,142824548.6,1.372890025,36135382.23,248.169998,227.449997,96.08348348,94.18131322,27309675.38,-2.878644223,64.38230776,31.51001,14.93023535,98.7925335,151952900
247.699997,253.5,244.399994,245.869995,8581200,116011539,2.561936007,37434973.63,253.5,227.449997,73.06740395,89.71696248,27259684.47,-17.95295294,63.1903005,24.159988,14.84958553,58.4358037,143371700
246.960007,248.449997,244.869995,245.199997,5313100,2349357.805,3.410881754,-1601794.222,253.5,231.789993,66.20519676,78.45202806,27236300.62,-19.78074742,62.51137734,19.589996,13.73440398,64.72174857,138058600
246,247.429993,241.169998,242.809998,4728100,1194647.904,3.846484549,-17793171.11,253.5,235.539993,56.47392968,65.24884346,27184513.09,-25.77767481,60.03353857,17.800003,9.516932179,-8.715126943,133330500
242.470001,245.600006,240.369995,244.789993,3865400,20751051.88,4.301882528,-16576863.02,253.5,242.809998,50.22853143,57.63588596,27223068.39,-21.14592517,61.39864825,24.11,8.501392631,-58.52842092,137195900
245,248.169998,242.369995,243.490005,4170200,17792147.8,4.505948768,-15513764.37,253.5,242.809998,23.76244335,43.48830149,27202540.7,-28.19716901,59.9507879,13.910003,8.212972939,-22.1120263,133025700
246,247.940002,244.839996,246.600006,4795800,7673395.408,4.862571129,-16888121.19,248.449997,242.809998,77.10407745,50.36501741,27255805.01,-20.1224713,62.24457496,19.150009,11.74552013,-16.75403576,137821500
246.490005,246.949997,238.160004,240.619995,6353000,17420933.36,4.609524283,-12813584.98,248.169998,240.619995,24.5753494,41.81395673,27139507.62,-37.56199367,55.64506194,8.830002,4.808778162,-14.09408678,131468500
240,245.179993,239.220001,241.229996,4340200,16900594.22,4.407399063,-10147420.35,248.169998,240.619995,30.66926913,44.11623199,27155613.25,-35.78304609,56.15572742,5.690003,6.05847403,3.599560796,135808700
241.520004,241.990005,222.610001,223.210007,12891500,1089902.695,2.761320079,-13164898.45,248.169998,223.210007,2.34744159,19.19735337,26831398.36,-92.77181797,41.1014396,-23.889999,-3.701620544,168.4219293,122917200
224.559998,228.979996,218.360001,228.699997,9427100,92470227.19,1.878136942,15873045.43,247.940002,223.210007,34.95603668,22.65758247,27148472.88,-70.57485403,45.8631286,-17.169998,-2.903963744,93.03192252,132344300
230.660004,243.309998,227.399994,242.559998,11884500,276836458.7,2.270422177,84971182.91,246.949997,223.210007,84.64498211,40.64948679,27719787.34,-31.13261898,55.61833255,-2.639999,-1.837316022,18.33851117,144228800
242.199997,248.710007,238.729996,242.130005,11116400,210075446.6,2.517592966,84271809.59,248.710007,223.210007,78.31960231,65.97354037,27698719.35,-32.35627582,55.28549128,-0.679993,-1.521125016,29.54365357,133112400
243,243.979996,236.110001,240.869995,5879800,56130897.09,2.582041158,27342272.06,248.710007,223.210007,74.16800511,79.04419651,27640871.19,-35.94196175,54.26077763,-3.919998,-1.765906221,10.66608948,127232600
241.5,245.949997,239.130005,244.690002,6162600,58789776.72,2.907839688,2413261.853,248.710007,228.699997,86.75451662,79.74737468,27734120.15,-25.07113902,56.87076242,1.199997,0.7742696,30.33988283,133395200
243.289993,244.649994,239.429993,243.130005,5631400,52321960.95,3.005512967,-10062298.42,248.710007,240.869995,73.81511687,78.24587953,27694831.1,-18.38550543,55.47850908,-3.470001,-0.678127394,45.68738035,127763800
231.860001,234.479996,224.279999,233.029999,15084500,149041478.7,2.242088271,16523209.71,248.710007,233.029999,35.81660718,65.46208022,27460893.82,-51.66393707,47.38952268,-7.589996,-4.295866682,261.7212604,112679300
231.610001,234.779999,228.070007,231.429993,7995000,152716547.3,1.49077684,27066329.43,245.949997,231.429993,32.99489922,47.54220775,27357322.21,-56.93578446,46.23934313,-9.800003,-6.151667734,66.70836982,104684300
229.800003,238.559998,228.550003,237.720001,8064200,96143517.55,1.386920638,10918338.99,245.949997,231.429993,62.02124246,43.61091628,27574617.36,-36.21088576,51.2487189,14.509994,-1.20521738,26.93530615,112748500
235.869995,243.940002,234.5,240.050003,8678200,117859941.3,1.475615561,10229537.82,244.649994,231.429993,77.41780987,57.47798385,27653658.26,-28.53378019,52.99592576,11.350006,-0.489156829,99.94931109,121426700
241.320007,247.300003,240.649994,244.529999,6894400,68466460.92,1.885668351,-6698309.853,247.300003,231.429993,87.96696994,75.80200742,27815617.44,-13.77267603,56.24313664,1.970001,9.551539506,-46.51979987,128321100
245.279999,249.279999,241.580002,244.740005,6283300,40029054.85,2.2021983,-22062666.75,249.279999,231.429993,78.59502257,81.3266008,27821538.45,-14.68303458,56.39520819,2.61,7.013558465,-33.34853773,134604400
247.149994,251.080002,246.809998,247.889999,8475400,18972252.68,2.676377145,-33042280.11,251.080002,237.720001,85.84108681,84.13435978,27902409.4,-9.749397624,58.71301715,7.020004,2.197394889,-28.68526232,143079800
247.899994,258.549988,247.130005,256.959991,10205000,101715872.8,3.740916889,-8202580.981,258.549988,240.050003,93.38878256,85.94163065,28212513.93,-3.956201827,64.55523079,12.269989,6.124803078,-8.19869742,153284800
257.700012,260,254.119995,257.890015,6432800,120837605.8,4.606516415,8788991.062,260,244.529999,89.09568814,89.4418525,28249449.23,-5.907012713,65.10055496,14.76001,7.066060677,9.405081806,159717600
257.390015,262.100006,256.920013,259.75,6684100,37826976.62,5.380571641,-11471383.38,262.100006,244.740005,88.54773128,90.34406733,28295844.63,-6.213658289,66.21989878,26.720001,6.154725521,8.462337325,166401700
262.5,264.779999,260.170013,261.970001,4769300,21561117.87,6.102802206,-23892365.86,264.779999,247.889999,84.36283893,87.33541945,28352971.52,-6.938266667,67.5573848,30.540008,7.748939091,-15.3088042,171171000
260.700012,262.799988,255.100006,256.950012,5749800,11946393.24,6.198649798,-29860874.18,264.779999,256.950012,55.63745234,76.18267418,28261580.01,-19.33330123,61.61639421,19.230011,10.2647784,-61.8827273,165421200
258.329987,259.5,250.179993,253.5,5020300,19704298.44,5.927889549,-27119487.36,264.779999,253.5,22.73976463,54.2466853,28184378.69,-27.85184938,57.85108971,13.449997,9.5363642,-37.20700438,160400900
254.320007,258.329987,250.850006,255.580002,4600800,33505780.72,5.814127239,-19141222.27,264.779999,253.5,36.98634781,38.45452159,28225570.94,-22.71604198,59.45958518,11.050003,7.513040941,-42.94784356,165001700
254.5,256.140015,251.350006,254.679993,5261100,35986081.33,5.586943774,-13348088.88,264.779999,253.5,30.82190514,30.18267253,28209369.51,-27.51296159,58.42069887,9.939988,6.094559391,-39.37567698,159740600
298.369995,304.929993,289.200012,299.679993,29720900,317470673.8,8.935025746,79798571.37,304.929993,253.5,90.4109589,52.73973729,29138965.5,-6.873528001,78.57618557,51.789994,22.55346756,331.0875493,189461500
297.720001,330,296.109985,328.130005,30006100,1260695128,13.72585986,410766479.4,330,253.5,97.65723523,72.96336643,31960508.42,-1.958109948,83.89239148,71.170014,34.07289299,377.5531966,219467600
327.540009,340.839996,322.600006,327.709991,18870300,1041983453,17.28943693,439229956.3,340.839996,254.679993,85.40948277,91.15922563,31922099.91,-13.10510504,83.56271835,69.819976,32.19976293,122.6478986,200597300
319.98999,324.299988,314.75,316.220001,12684300,90757308.01,18.96780225,108281245.6,340.839996,254.679993,72.48854872,85.18508891,31260479.69,-24.8035427,74.89232398,56.470001,23.06195987,24.29495345,187913000
313,318.790009,309.970001,315.01001,9641800,52376653.54,19.97008004,-49162639.4,340.839996,299.679993,49.98064678,69.29289275,31211944.21,-27.46994209,74.02129988,53.040009,22.14897502,49.88496456,178271200
313.100006,319,313,314.920013,5067000,50745720.47,20.52058191,-109621103.8,340.839996,314.920013,42.05236614,54.84052055,31209189.59,-27.65978603,73.95240678,57.970001,21.23965852,-24.19323469,173204200
316.320007,316.480011,309.799988,313.309998,6383900,25661222.22,20.58959976,-132369988.4,340.839996,313.309998,11.30801899,34.44701064,31183284.77,-30.36620019,72.6497213,59.809998,19.59766263,33.8540247,166820300
314.799988,321.940002,309.26001,317.470001,8787000,88421628.24,20.74088636,-109673494.8,324.299988,313.309998,54.58778597,35.9827237,31268047.6,-25.77762434,73.92767586,61.889999,23.55321509,52.82270688,175607300
319.619995,323.51001,316.119995,317.220001,6943400,70771471.76,20.60310935,-96034206.81,323.51001,313.309998,55.85958596,40.58513031,31261128.05,-26.0533799,73.70479107,62.540008,25.13609507,38.30647571,168663900
318,326.720001,314.5,326.579987,7940900,97562892.62,21.00703667,-73199572.64,326.720001,313.309998,99.19808664,69.88181952,31466002.04,-15.72910713,76.55480564,26.899994,27.7799454,72.59824378,176604800
329.140015,341.5,328.019989,335.540009,14467300,198232862.6,21.79886711,-25172270.7,341.5,313.309998,81.51366982,78.85711414,31683867.93,-6.526489863,78.91116539,7.410004,31.74965377,174.9862196,191072100
334.5,337.459991,332.5,337.140015,6069200,130167525.3,22.29846275,-24893502.63,341.5,317.220001,86.47646913,89.06274187,31752854.53,-4.809691438,79.31103983,9.430024,12.50000763,-79.57935325,197141300
343.950012,349.190002,342,345.089996,9986700,52933722.46,23.06995682,-47090807.26,349.190002,317.220001,88.18101538,85.39038478,31895970.22,-4.190521431,81.21680621,28.869995,5.168680322,-66.71776739,207128000
346.899994,350.369995,344.040009,349.929993,7359400,67999266.98,23.79759488,-47096957.96,350.369995,326.579987,98.77334246,91.14360899,32036036.87,-0.719310319,82.28659196,34.919983,6.780385893,-61.00009009,214487400
355,356.329987,345.179993,346.109985,8420100,42948015.2,23.79175403,-50788785.36,356.329987,335.540009,63.89967248,83.6180101,31955698.03,-16.9711087,78.48706673,31.189972,9.452274969,-33.61793713,206067300
346.109985,353.839996,342.910004,349.350006,6464900,39091042.29,23.77450998,-48909134.74,356.329987,337.140015,70.70925385,77.79408959,32034520.67,-14.828945,79.3576833,36.040008,10.90123961,-32.94924184,212532200
350.640015,352.799988,348.359985,352.170013,4809000,56618312.09,23.71502292,-38117043.21,356.329987,345.089996,70.97014812,68.52635815,32086706.34,-8.83785008,80.11208658,34.700012,11.82840038,-5.091770278,217341200
352.920013,353.149994,346.100006,349.98999,4400400,32785195.95,23.22425461,-37820175.15,356.329987,346.109985,52.7570415,64.81214782,32056937.39,-13.46930125,77.74659145,32.769989,11.70725232,-31.07034885,212940800
351.75,359.98999,347.799988,359.519989,7724800,105381926.1,23.3353135,-11161571.79,359.98999,346.109985,97.24823545,73.65847502,32176757.41,-0.926475824,80.46246885,32.940002,13.2453422,-12.08831228,220665600
360,361.200012,349.570007,352.220001,6725100,102865569.2,22.57406072,-41750.16668,361.200012,349.350006,50.90209365,66.96912353,32019906.75,-17.28920034,73.10274868,16.679992,11.03335221,-3.143992857,213940500
354.51001,360.839996,354,354.829987,6110000,12331372.5,21.92858736,-24295272.09,361.200012,349.98999,57.81442074,68.65491661,32069740.42,-12.2641986,74.01779824,17.689972,8.650254493,-23.05658049,220050500
340.160004,341,330,333.040009,16870600,38781237.52,19.43474432,-23592640.18,361.200012,333.040009,9.743614842,39.48670974,31694527.59,-60.2997768,56.68073652,-12.049987,-0.745067632,16.61194556,203179900
344.320007,344.570007,334.459991,336.339996,12339500,52232019.73,17.52264695,-16880620.04,361.200012,333.040009,20.32049218,29.29284259,31861692.97,-53.23342529,58.27470196,-13.589997,-0.237295772,103.3134515,215519400
335.269989,335.5,327.100006,328.920013,7947400,21392277.88,15.23296921,-22412836.93,361.200012,328.920013,5.337262991,11.80045667,31589471.76,-94.66273701,53.50725497,-17.189972,-4.685729284,-20.42015881,207572000
331.119995,333.929993,328.570007,331.290009,5555600,20613780.4,13.45452656,-22886189.68,360.839996,328.920013,12.41850694,12.69208737,31646735.86,-87.71260334,54.77978438,-18.059997,-5.326775176,-24.51015028,213127600
331.109985,331.26001,327.5,329.940002,2465600,17525395.26,11.80013901,-21981939.29,344.570007,328.920013,16.25641578,11.33739524,31624096.78,-91.67156745,53.87520913,-22.230011,-4.671920401,-70.71768744,210662000
329.399994,336.380005,328.690002,334.869995,6074500,41498060.87,10.7627677,-11985994.23,344.570007,328.920013,44.47617948,24.38370074,31660938,-77.21411251,56.68794004,-15.119995,-4.144843495,-6.038763167,216736500
332.619995,337.910004,332.190002,336.200012,6573700,60742975.97,9.933458006,-683726.0605,337.910004,328.920013,84.18138468,48.30465998,31685064.34,-73.31377009,57.44193973,-23.319977,-4.534741861,36.69577875,223310200
337.75,337.859985,332.850006,333.029999,5533000,20057082.9,8.91763361,-8943425.417,337.910004,329.940002,53.12196806,60.59317741,31623081.25,-82.60999426,54.98499679,-19.190002,-4.845850306,25.73856922,217777200
332.829987,334.420013,327.25,330.369995,3724600,5178559.075,7.80794029,-16243430.42,337.910004,329.940002,29.2682348,55.52386251,31578887.63,-90.41059113,52.93880636,-24.459992,-8.108031512,-51.78386495,214052600
335,338.859985,334.769989,335.890015,7612400,12515179.83,7.289886546,-15418741.28,338.859985,330.369995,74.41883,52.26967762,31641120.48,-74.22285204,56.55218007,2.850006,-4.636302866,13.19385585,221665000
336.589996,344.450012,335.079987,339.529999,9023100,38413359.21,7.091297447,-5439334.897,344.450012,330.369995,71.39529321,58.360786,31723614.79,-63.54841404,58.79867102,3.190003,-4.311920796,47.67757774,230688100
339.959991,350.730011,339.309998,348.839996,8828300,118087649.2,7.597573014,24488544.96,350.730011,330.369995,91.95053614,79.25488645,31971030.43,-36.24637485,63.93504697,19.919983,4.744170842,-47.67050372,239516400
351.880005,357.190002,351.089996,352.700012,6897800,88700947.04,8.215567136,25155222.87,357.190002,330.369995,85.00337442,82.78306792,32068718.14,-24.12562659,65.8366932,21.410003,4.864130402,-44.09984197,246414200
354.920013,362.73999,353.230011,359.679993,7763900,53607200.33,9.16293347,11974924.16,362.73999,335.890015,89.05971795,88.6712095,32205226.54,-8.585854023,69.01798719,29.739991,9.351811621,-2.308931223,254178100
361.049988,365.209991,354.640015,358.390015,6570900,67980037.68,9.697846928,10067529.83,365.209991,339.529999,77.3648354,83.80930925,32177381.62,-17.89550954,67.76212023,23.52002,8.180145873,18.2752538,247607200
362.549988,383.609985,362.5,381.5,18174200,363894441.5,11.84995346,102526585.2,383.609985,348.839996,95.23705278,87.22053537,32601091.53,-3.733827259,76.13885365,45.299988,15.62708301,637.1106424,265781400
378.98999,385.5,375.899994,378.98999,8496800,363986432.8,13.20080589,131059415.5,385.5,352.700012,81.08105422,84.5609808,32481517.68,-11.17598283,73.89304747,45.959991,13.17526075,39.87653305,257284600
380.630005,395.220001,380.579987,393.149994,14121000,195997627.5,15.23830249,77366461.18,395.220001,358.390015,95.07023698,90.46278133,32798979.15,-3.045471487,77.86045829,62.779999,16.93931587,114.8105329,271405600
397.320007,406.850006,396.5,404.040009,18107100,307116118.4,17.52969501,83723730.49,406.850006,358.390015,94.61789411,90.2563951,33190122.24,-3.530146719,80.3355059,68.149994,21.32240645,227.2564612,289512700
410.290009,413,400.190002,405.589996,14752700,202742393.5,19.24882265,45503361.79,413,378.98999,85.32672475,91.67161861,33259585.09,-8.641404082,80.66679192,66.059997,22.76841182,296.0881705,304265400
411.779999,422.01001,410,419.220001,13319600,190843211.8,21.46365156,21944983.89,422.01001,378.98999,93.94923437,91.29795108,33755355.14,-2.944289474,83.32684747,70.380005,24.80871186,74.97241343,317585000
418.359985,425.470001,412.690002,425.25,8054700,220740847.9,23.43534192,19825351.34,425.470001,393.149994,99.50991105,92.92862339,33946942.32,-0.223987984,84.35258288,72.549988,25.24666488,-10.73245337,325639700
427.910004,433.480011,426.350006,430.940002,10633900,146049672.5,25.16694744,-6609449.723,433.480011,404.040009,93.1314001,95.53018184,34054717.18,-2.573202749,85.27325352,71.260009,23.53514704,20.45240873,336273600
435,435.309998,426.109985,430.380005,9945700,82160069.12,26.19214349,-37151337.62,435.309998,405.589996,85.96243291,92.86791468,34040898.66,-4.918679496,84.74476872,71.98999,22.02438059,44.18655223,326327900
428.790009,429,409.26001,414.700012,12586400,96490991.79,25.44604815,-41708512.94,435.309998,414.700012,20.88293476,66.65892259,33678547.93,-21.46873542,71.40125102,33.200012,15.29693619,62.11440127,313741500
405,421.290009,402.079987,418.329987,10285700,224909965.1,24.86108772,1079453.483,435.309998,414.700012,48.90157876,51.91564881,33788719.9,-20.16149442,72.48150187,39.339997,16.7247885,56.53411253,324027200
424.5,430.700012,421.709991,430.26001,9532100,246590831.3,25.07115089,25383946.87,435.309998,414.700012,84.8029301,51.52914787,34082049.67,-6.152520468,75.72661774,37.110016,12.78112975,-47.55147407,333559300
440.5,454,436.920013,443.01001,17778500,177864671.6,25.9671132,11151648.17,454,414.700012,78.83284428,70.84578438,34364516.72,-11.06078066,78.62740761,38.970001,16.89227201,109.2375953,351337800
440.470001,451.559998,440,451.540009,10133000,213748958.4,27.05361221,15733285.57,454,414.700012,95.26195997,86.29924478,34706835.37,-2.688514754,80.32173115,45.950013,14.85184176,-28.24162595,361470800
461.399994,471.630005,453.359985,469.059998,17882100,395151153.1,28.99416056,73896173.22,471.630005,418.329987,96.30480757,90.13320394,35100001.08,-2.68464087,83.25754096,49.839997,16.09246301,-1.242606491,379352900
473.700012,498.48999,468.230011,492.140015,31144300,1016358554,32.02525637,288629148,498.48999,430.26001,91.72964954,94.43213903,35979886.75,-5.385442149,86.18215368,66.890015,21.33928841,111.1091529,410497200
497.100006,498.799988,472.869995,481.339996,28440400,959864629.1,33.17354638,332260102.8,498.799988,443.01001,71.78409978,86.60618563,35296424.68,-17.06744286,79.20947971,50.399994,14.8179941,113.5229286,382056800
481.790009,484.940002,473.700012,478.149994,12959500,271580627.3,33.44068458,100904210.8,498.799988,451.540009,64.88095542,76.13156825,35107940.59,-20.94107791,77.22212725,47.769989,12.43973992,60.89363974,369097300
493.5,525.630005,492,524.859985,26517600,920601558.1,36.9950436,203592168.3,525.630005,469.059998,98.93452361,78.53319294,36373941.08,-0.623245559,83.67927469,110.159973,21.79421325,149.3685289,395614900
544.26001,547.409973,524.900024,537.919983,28996200,1236065570,40.40002508,327467412.3,547.409973,478.149994,88.01465704,83.94337869,37033773.82,-6.529960032,84.96282203,119.589996,24.98721519,191.5450898,424611100
529.76001,537.840027,516.789978,518.5,17368800,379048002.8,41.05817404,75686475.82,547.409973,478.149994,61.21547956,82.72155341,35986953.24,-19.89264143,75.45947414,88.23999,25.03013865,37.99656772,407242300
493.75,514.460022,492.170013,513.48999,21736700,476223193.5,40.70625947,-3276026.22,547.409973,478.149994,53.98181936,67.73731866,35819127.08,-23.33997541,73.18518689,70.47998,22.74759304,111.3293213,385505600
507.609985,515.669983,503.160004,510.5,13629100,556885050.1,39.72813621,-9615911.191,547.409973,510.5,33.38749145,49.52826346,35692556.91,-25.39735537,71.79447116,58.959991,18.6491861,42.98108497,371876500
530.25,548.580017,528.409973,547.200012,17803500,427715428.6,41.43669431,-52434751.78,548.580017,510.5,97.55361655,61.64097579,36672357.37,-0.941982742,77.4569752,78.140014,23.51865638,0.140619287,389680000
571.890015,594.5,559.099976,569.559998,31369000,639330732.4,44.08679776,2147387.518,594.5,510.5,75.62786556,68.85632452,37399853.72,-14.43370606,80.08080716,77.419983,26.13721634,209.5726833,421049000
564.25,582,555.599976,572.200012,19651000,624932996.1,45.87127539,19700129.57,594.5,510.5,78.20776817,83.79641676,37545254.73,-14.15153563,80.37129956,90.860016,21.98866125,9.89201492,440700000
570.630005,573.859985,554.26001,564.820007,14353600,463866382.4,46.15790247,-26158592.12,594.5,510.5,67.5060277,73.78055381,37291804.06,-19.21035146,76.99112743,86.670013,14.76815333,-53.91259396,426346400
541.98999,564.440002,539.280029,558.02002,13608100,396497089.2,45.31400277,-63976608.63,594.5,547.200012,44.8025948,63.50546356,37118998.04,-25.84666014,73.90681461,33.160035,15.9305324,-52.15222008,412738300
568.48999,576.809998,558.080017,566.900024,11788500,349280734.7,44.84480528,-88654945.58,594.5,558.02002,50.01812659,54.10891636,37335549.38,-21.85790639,75.29846894,28.980041,18.56112749,-9.035842432,424526800
575.690002,589.799988,567.429993,580.98999,17801500,332114897.9,45.09013439,-96152945.52,589.799988,558.02002,82.56135164,59.12735768,37628545.6,-11.10746481,77.36162026,62.48999,10.69428164,-32.86911334,442328300
632.419983,650.880005,618,640.809998,29005700,887114021.1,49.54046257,86111497.84,650.880005,558.02002,90.9766943,74.51872418,39461427.22,-5.683489896,83.61771057,127.320008,19.12738293,0.032762914,471334000
640,653,632.52002,650.570007,15719300,934604549.9,53.24119947,167956529.5,653,558.02002,97.86317832,90.46707475,39903205.43,-1.509312422,84.37633867,140.070007,25.47155391,-9.496914007,487053300
673.690002,786.140015,673.52002,780,47233500,5308715009,65.85879962,1577932231,786.140015,566.900024,97.30771944,95.38253068,43030538.18,-2.08865359,90.59573796,232.799988,51.9016953,117.298394,534286800
882.960022,968.98999,833.880005,887.059998,60938800,8230618962,83.53425485,2940988801,968.98999,580.98999,79.59707326,91.58932367,49513638.71,-17.18258377,93.05755201,317.5,73.76297708,347.1227007,595225600
823.26001,845.97998,704.109985,734.700012,48423800,4647074682,84.27651571,2091021599,968.98999,640.809998,33.24881487,70.05120252,39046889.3,-49.13594004,66.41284341,162.5,34.26535013,171.990339,546801800
699.919983,795.830017,687,748.960022,39880800,3897142414,85.03519364,1314600058,968.98999,650.570007,34.60635789,49.15074867,39986761.16,-47.23396402,67.35497159,184.140015,31.49800278,27.13443208,586682600
730.549988,769.75,730,748.070007,17063500,2752870703,84.58953905,513377514.8,968.98999,734.700012,25.23098608,31.02871961,39939369.44,-50.14298753,67.22822083,190.049987,30.73575521,-13.16726884,569619100
800,819.98999,752.400024,771.280029,24689200,747370474.4,85.12790784,-499179736.1,968.98999,734.700012,29.88759601,29.90831333,40468790.76,-46.01009493,68.87326431,204.380005,36.55324164,72.00702263,594308300
768.789978,783.51001,758,774.380005,11697500,635758076,84.82687967,-903540762.2,845.97998,734.700012,54.96289847,36.69382685,40568023.1,-45.28868368,69.09639228,193.390015,38.77279976,-14.04016725,606005800
777.869995,789.75,763.369995,767.289978,12022500,224310585.9,83.05875711,-1117736223,819.98999,748.070007,60.37294837,48.40781428,40460923.76,-46.93864008,67.89758601,126.47998,35.34837635,1.984985367,593983300
741.840027,818,735,804,26289300,1846419360,83.65537216,-587623736,819.98999,748.070007,82.23136818,65.85573834,41036125.12,-38.39566335,70.72929282,153.429993,38.38448404,47.68025166,620272600
787.219971,812.969971,785.5,800.030029,15693700,2030164638,82.85277519,-258874790.6,819.98999,767.289978,76.51492723,73.03974793,40906314.47,-41.11848631,70.01007816,20.030029,24.84668334,-45.89442765,604578900
841.599976,860,832.359985,858.400024,16381700,646269109.7,85.93606462,-541182909.1,860,767.289978,98.7200192,85.82210487,42051322.98,-27.54008537,74.16905509,-28.659974,31.94583439,4.213928101,620960600
923.5,944.780029,901.02002,917.419983,25423000,826672883.4,92.08056373,-550072946.9,944.780029,767.289978,86.95774515,87.39756386,43177659.46,-14.6927287,77.55801463,182.719971,17.61794654,-46.17591328,646383600
911.950012,912,859.940002,899.409973,17634900,1092825274,94.40858288,-419018297.5,944.780029,800.030029,78.37255709,88.01677382,42678576.72,-20.67941368,74.35233274,150.449951,1.392236718,-71.06129428,628748700
906.97998,913.059998,880.450012,901,14314800,980659215.5,95.28348798,-363001659.7,944.780029,800.030029,72.51379895,79.28136707,42709752.68,-23.01079531,74.45272807,152.929993,22.63508715,-70.43850338,643063500
839,863.5,822.200012,833.789978,15192200,454023243.2,89.52161998,-474651602.8,944.780029,833.789978,9.455020715,53.44712559,41641941.33,-47.94496854,63.19253962,62.509949,11.32636636,-61.90597982,627871300
849,856.599976,787,799.909973,17290500,374284821.9,81.28446808,-502547749.6,944.780029,799.909973,8.182260506,30.05036006,41024625.43,-56.19909989,58.39789576,25.529968,6.92982816,1.330324963,610580800
782.5,813.309998,776.109985,778.799988,14085500,233959657.9,72.22055291,-512922566.5,913.059998,778.799988,1.964222523,6.533834581,40568321.33,-64.38824669,55.56878105,11.51001,0.974997241,-42.94873872,596495300
730,739.77002,669,679,24277200,246748321.9,56.33491602,-466468365.1,913.059998,679,4.097353143,4.747945391,38763322.94,-96.37392162,44.57449489,-125,-12.3169509,107.5417824,572218100
629.700012,690.52002,611.52002,667.98999,24564200,1602059402,42.36861947,26177185.11,863.5,667.98999,22.41049864,9.490691437,38369667.24,-83.05528162,43.55079154,-132.040039,-12.94165059,104.3185693,547653900
711.26001,743.690002,686.669983,743.619995,20195000,2530214864,36.97669386,520656449.5,856.599976,667.98999,53.90076657,26.80287279,41150832.53,-60.36128805,51.74845393,-114.780029,-7.509950871,-23.18167467,567848900
805,806.97998,716.109985,745.51001,25784000,1890689083,32.48163432,472125540.7,813.309998,667.98999,66.4007159,47.57066037,41202160.96,-59.7941588,51.93630132,-171.909973,-6.814746575,64.29522675,593632900
763.960022,766.52002,724.72998,749.5,15049000,1107243341,28.90799275,160073293,806.97998,667.98999,70.5924528,63.63131176,41340157.64,-58.59689844,52.35797393,-149.909973,-12.68639573,-8.135297313,608681900
723.77002,745.75,718.070007,724.539978,10852700,428535639.9,23.78758244,-198089012.6,806.97998,667.98999,57.82256274,64.93857714,40838992.37,-66.08655256,49.43610779,-176.460022,-21.02417743,-57.3114896,597829200
690,707,684.27002,703.47998,12662900,303193478.7,17.82478157,-366483460.5,806.97998,703.47998,15.65476837,48.0232613,40523540.01,-72.40594205,47.05028707,-130.309998,-21.78428068,-28.1940924,585166300
605.390015,663,605,608,17073700,276323317.4,5.33330348,-410605016.9,806.97998,608,1.485295721,24.98754228,38804865.04,-99.11707583,38.07794679,-191.909973,-32.51942286,19.27306005,568092600
659.429993,668,608,645.330017,15594400,611277659.8,-1.536352393,-284750634,766.52002,608,24.96905151,14.03637187,39853157,-86.90838887,42.68028012,-133.469971,-22.60280958,2.647411172,583687000
640.200012,653.580017,613,634.22998,13322500,852730890.4,-7.786526158,-130552300.9,745.75,608,20.76730373,15.74055032,39584924.6,-90.51159508,41.68808834,-44.77002,-20.71232996,-22.94901825,570364500
580.890015,594.5,546.25,560.549988,18909100,533578699.2,-18.4722568,-157151198.1,707,560.549988,8.895793468,18.21071624,38037218.37,-95.49251757,35.74756562,-107.440002,-28.02388333,34.24514572,551455400
595,607.570007,502,546.619995,22640300,1254233820,-27.74498246,75553264.06,668,546.619995,26.87951506,18.84753742,37567316.24,-87.41680823,34.7396501,-197,-19.49631885,-6.742540326,528815100
469.5,494.869995,442.170013,445.070007,20489500,1037196305,-42.79461006,94824674.23,668,445.070007,1.284149213,12.35315258,33361245.82,-99.21862529,28.44350849,-300.440003,-33.37175502,-16.58796134,508325600
440.01001,471.850006,396,430.200012,23994600,847497364.8,-55.2841514,33729254.4,653.580017,430.200012,13.27743215,13.81369881,32676682.14,-91.67842385,27.65317625,-319.299988,-42.14786922,18.81455806,484331000
389,404.859985,350.51001,361.220001,23786200,1043090936,-69.94206471,67903695.93,607.570007,361.220001,4.166339036,6.242640134,28829290.86,-97.65373591,24.28249993,-363.319977,-51.54726346,-7.748215948,460544800
374.700012,452,358.459991,427.640015,30195500,2316712809,-75.3306616,480954409.3,607.570007,361.220001,30.00467047,15.81614722,33203023.58,-83.10293994,32.77895342,-275.839965,-42.94329353,100.6478836,490740300
438.200012,477,425.790009,427.529999,28285500,2102953866,-78.7028039,538192363.8,494.869995,361.220001,53.35272721,29.1745789,33195255.39,-83.12704141,32.77239362,-180.470001,-40.99290419,160.6309951,462454800
433.600006,442,410.5,434.290009,16454500,409317332.1,-79.90863762,-26203039.68,477,361.220001,66.23448939,49.86396235,33642499.48,-79.86106176,33.65102449,-211.040008,-38.26547715,29.94258819,478909300
477.299988,513.690002,474,505,22895200,1092163640,-74.30205636,-37440693.91,513.690002,361.220001,94.67459099,71.42060253,36321579.18,-60.91235859,42.16560295,-129.22998,-16.94078947,34.09630016,501804500
545.25,557,511.109985,539.25,21222700,1293736643,-66.33049489,25502647.68,557,427.529999,91.05973648,83.98960562,37874372.45,-47.05601972,45.79420331,-21.299988,-16.43810364,36.09180219,523027200
547.390015,560,512.25,528.159973,17380700,853935173.1,-60.21374097,-91003057.22,560,427.529999,78.70232308,88.14555018,37437913.82,-44.04549164,44.81376323,-18.460022,-16.7242184,30.46124977,505646500
505,525.799988,494.029999,514.359985,14377400,552052104.4,-55.83606967,-226445180.4,560,434.290009,69.47156187,79.74454048,36983783.51,-48.39208159,43.56388435,69.289978,-8.240122021,-23.96570963,491269100
510.26001,516.650024,491.230011,502.130005,11998100,411041059,-52.74557266,-306134547.1,560,502.130005,32.70930814,60.2943977,36641930.88,-49.97195648,42.43433392,71.929993,-8.139107681,-47.00556088,479271000
501.25,542.960022,497,524,17771500,596425023.8,-47.97853897,-251918522.2,560,502.130005,47.65158389,49.9441513,37164501.49,-32.50992297,45.17205151,162.779999,17.73428714,-13.26533102,497042500
504,513.950012,475.100006,481.559998,13353200,547627911,-47.08244676,-222363909.5,560,481.559998,7.608942823,29.32327828,35725145.59,-49.01968819,41.08833958,53.919983,11.93862961,-44.34914522,483689300
481.029999,494.26001,446.399994,454.470001,19858400,218876228.4,-48.00485352,-294661293.4,542.960022,454.470001,8.357502755,21.20600982,34973965.78,-50.37472148,38.68431742,26.940002,25.81529255,-16.51293607,463830900
509.5,515.48999,468.390015,480.01001,22562100,388923154.4,-46.14309338,-243344265.4,542.960022,454.470001,34.80738013,16.92460857,36089955.2,-38.18320388,42.12248114,45.720001,12.24628032,-25.27992582,486393000
511.200012,521,497.959991,516.23999,14901800,514501879.1,-41.26846133,-160271862.9,542.960022,454.470001,72.32806105,38.49764798,37792887.25,-20.88883101,46.68917715,11.23999,20.74941904,-47.31646957,501294800
545,565,532.340027,545.450012,17919800,493527879.4,-34.6488651,-118391074.3,565,454.470001,83.51603119,63.55049079,38636064.68,-9.465472619,50.10722642,6.200012,25.5958002,8.905162721,519214600
554.200012,557.210022,533.330017,548.840027,12656000,416060396.4,-28.79728435,-115143944,565,454.470001,86.37439108,80.73949444,38747437.65,-10.45952945,50.50385928,20.680054,8.681193465,-44.72203781,531870600
562.090027,575.179993,557.109985,573,13650000,407110678.5,-21.95724706,-106195578.8,575.179993,480.01001,97.95861649,89.28301292,39304555.58,-1.323775257,53.35015954,58.640015,6.258692629,-35.68207627,545520600
